Huyền Võ=Huyền Vũ
Thuần dưỡng thực=Lục thực thuần dưỡng
Mục Lương trước mặt=trước mặt Mục Lương
Mục Lương giọng nói=giọng nói của Mục Lương 
Huyền Vũ vương quốc=vương quốc Huyền Vũ
Huyền Vũ quốc=vương quốc Huyền Vũ
Huyền Vũ nước=vương quốc Huyền Vũ
cao địa=Khu vực Trung Ương
cao nguyên=Khu vực Trung Ương
nhất hào vệ thành=Vệ Thành Số Một
Số 2 vệ thành=Vệ Thành Số Hai
số 3 Vệ Thành=Vệ Thành Số Ba
Vệ Thành Số Bốn=Vệ Thành Số Bốn
số mười Vệ Thành=Vệ Thành Số Mười
số tám Vệ Thành=Vệ Thành Số Tám
số chín Vệ Thành=Vệ Thành Số Chín
Tóc hồng thiếu nữ=cô gái tóc hồng 
xanh phát thiếu nữ=cô gái tóc xanh
thất tầng=tầng bảy
cô gái tóc bạc=cô gái tóc trắng
Lục Lạc Chuông=chuông lục lạc
hư bốn Vương=Hư Tứ Vương
Lý Cách Tư vương quốc=vương quốc Lý Cách Tư
Tạp Lặc phu vương quốc=vương quốc Tạp Lặc Phu
tháp cơ bằng lòng thành=thành Tháp Cơ
Ác hằng vương quốc=vương quốc Ác Hằng
Long ách=Long Ách
mặc dâu=Mặc Đình
bảy màu hồ=hồ bảy màu
Winksha=Ôn Sa
xà nhân nhất tộc=xà nhân tộc
Huyền đinh tửu lâu=Quán Rượu Huyền Đinh
nhất hào ốc đảo=ốc đảo số một
Bát túc Độc Hạt=Bát Túc Độc Hạt
ma văn ngươi=Ma Văn Nhĩ
Cát con rùa=Rùa Cát
cát quy=Rùa Cát
khiến Hư Quỷ thay đổi bí dược=bí dược thay đổi Hư Quỷ 
Thúy anh=Thúy Anh
Tề Nhĩ nạp=Tề Nhĩ Nạp
Mỹ Hương lầu=Mỹ Hương Lâu
Chu Tước roi=Roi Chu Tước
Franky man=Phất Lan Cơ
bào tử phấn=phấn bào tử
Bào tử phục sinh=Bào Tử Phục Sinh
vào huyễn=Mê Huyễn
Biến ảo nấm=Nấm Biến Ảo
Kỳ huyễn nấm=Nấm Kỳ Huyễn
Tiếu đức=Tiếu Đức
Ngưu như=Ngưu Như
cắn nuốt không gian=Không Gian Cắn Nuốt
thẻ bên trong=Tạp Lý
Thẻ miện y=Tạp Nhi Y
Kaniy=Tạp Nhi Y
Huyền Vũ biên giới=biên giới Huyền Vũ
ba sáng quả=quả ba quang
Ba lê quả=quả ba lê
Lai hi vương quốc=vương quốc Lai Hi
La Phù vương quốc=vương quốc La Phù
Mộc Lam Thành=thành Mộc Lam
hương tạ y=Hương Tạ Y
nâng Lạc Thành=thành Nâng Lạc
Thiên Phủ thành=thành Thiên Phủ
tầm già thành=thành Tầm Già 
tín hiệu truyền tháp=tháp truyền tín hiệu
Tử Kim hội viên=hội viên Tử Kim
Bạch Kim hội viên=hội viên Bạch Kim
Bạch Ngân hội viên=hội viên Bạch Ngân
hắc thiết Hội Viên=hội viên Hắc Thiết
Huyền Vũ công hội=Công hội Huyền Vũ
Mị có thể=Mị Khả
quang vinh xấu hổ=Quang Vinh và Hổ Thẹn
Cựu Đại Lục=đại lục cũ
phó thành chủ=phó thành chủ
xử phạt thư=giấy xử phạt
Ohna=Áo Nạp
Ồna=Áo Nạp
Nayuki=Đào Tuyết
Thiên Hải Thành=thành Thiên Hải
ngọc cách=Ngọc Cách
Ma Cà Rồng thiếu niên=thiếu niên Ma Cà Rồng
Sương Nhi=Sương Nhi
kẹo tiệm=cửa hàng bánh kẹo
Simu=Tư Mộ
Duy trì trật tự binh=binh sĩ duy trì trật tự
vỗ phóng ra linh khí=linh khí phóng đạn đạo
đạn đạo phóng ra linh khí=linh khí phóng đạn đạo
Tát khải=Tát Khải
Cherrell=Thiết Lôi Nhĩ
Cắt Raikiri=Thiết Lôi Nhĩ
Đức lạt cơ=Đức Lạt Cơ
Drake=Đức Lạt Cơ
Magev=Mã Cách Phu
mục nát chúng=Bất Hủ Chúng
Đại Quý Tộc=đại quý tộc
Thận Lâu trùng=Trùng Thận Lâu
phụng lão đại nhân=phụng giả
Hắc hồng=Tiểu Phấn
Quên nghĩ quả=quả đãng trí
chiểu dương cỏ=cỏ chiểu dương
Ma huyễn hoa=hoa ma huyễn
cơ thể con người linh khí hóa thực nghiệm=Thí Nghiệm Linh Khí Cơ Thể Người
Thải hồng nấm=Nấm Cầu Vồng
phục chế ma pháp trận=ma pháp trận sao chép
Ma pháp trận in ấn linh khí=linh khí in ấn ma pháp trận
Sao chép ma pháp trận=ma pháp trận sao chép
phòng ngự ma pháp trận=ma pháp trận phòng ngự
củng cố ma pháp trận=ma pháp trận củng cố
bồi bàn=hầu giả
Bất hủ lão=bất hủ giả
trường sinh viện nghiên cứu=viện nghiên cứu Trường Sinh
Dạ Huyền=Dạ Huyền
bất hủ chúng=Bất Hủ Chúng
Lell=Lai Nhĩ
Kano lợi=Tạp Nặc Lợi
độ mẫu vương quốc=vương quốc Độ Mẫu
Lệ Xương thành=thành Lệ Xương
thực chiến diễn tập=diễn tập thực chiến
u linh chiến thuật ám sát đội=Đội Ám Sát U Linh Chiến Thuật
tinh liên trà=trà Tinh Liên
Toàn bộ Dân Ca tay=Giọng Hát Vàng
Ất Nhị=Ất Nhị
Đinh đội=đội Đinh
Bính đội=đội Bính
ất đội=đội Ất
giáp đội=đội Giáp
Lôi Long=Lôi Long
Đường đang=Đường Đan
sa thẳng thắn thành=thành Sa Thản
rắc tân thành=thành Rắc Tân
lan hơi thở=Lan Diễm
kim hội trưởng=Kim hội trưởng
ấm ny Toa=Ấm Ny Toa
Nga tư nữ vương=nữ vương Nga Tư
Cương Ngột thành=thành Cương Ngột
Nga tư vương quốc=vương quốc Nga Tư
Rahsa khắc tư=Kéo Khắc Tư
Ouro=Áo La
lẩu xào cay tiệm=Cửa hàng lẩu xào cay
lê nhã thành=thành Lê Nhã
nhuận la thành=thành Nhuận La
Mbeck=Mỗ Bối Khắc
Dilima=Đạt Minh
Kshina=Tú Na
Rander=Lục Cơ
Pano=Gia Lý
thẻ băng=Tử Băng
Adidas=A Đạt Tư
Necolin=Ni Khả Lâm
thần thánh Thiên Phạt=Thiên Phạt 
Quang phục thành=thành Quang Phục
thủy tinh thành=thành Thủy Tinh
Thánh Quang khôi giáp=Khôi Giáp Thánh Quang
tiểu ô=Tiểu Ô
Tiểu Mịch=Tiểu Mật
Ba lượt xe đạp=xe đạp ba bánh
Lai hứa một lời=Hạ Nhất Nặc
"Tử"=Thú Sương Tím
Tuyết duyệt=Tuyết Duyệt
tuyết Phong vương quốc=vương quốc Tuyết Phong
huyết sắc lĩnh vực=Lĩnh vực Huyết Sắc
Tiểu cầu=Tiểu Cầu
Mềm hoá=Mềm Hoá
Lưu Vân báo=Báo Lưu Vân
Nhĩ Mạn thành=thành Nhĩ Mạn
German=Nhĩ Mạn
Kleiman=Khắc Lai Mạn
Sini=Tây Ni
Thánh Quang hộ vệ=Hộ Vệ Thánh Quang
Thần thánh lôi điện=Lôi Điện Thần Thánh
Thánh lôi chim=Chim Thánh Lôi
Thánh Quang Kim Ô=Kim Ô Thánh Quang
Thần thánh Lôi Phạt=Lôi Phạt Thần Thánh
Cay bên tai=quả cay
kỳ vị quả=quả kỳ vị
sợi Hera=Sa Hách Lạp
Hoắc Nguyên mới=Hoắc Nguyên Tân
Không gian Bích Lũy=Hàng Rào Không Gian
Dược Viên=Vườn Thuốc
cách lạc=Cách Lạc
lặc Thái thành=thành Lang Thái
cương ni thành=thành Cương Ni
nguyệt lưu thành=thành Nguyệt Lưu
Đại La thành=thành Đại La
An Kỳ=An Kỳ
Morage=Hải Cảnh
Hải Cảnh thành=thành Hải Cảnh
phục hợp cung ghép=Cung Phức Hợp
mệnh thạch=Đá Sinh Mệnh
Nam này=Ánh Nam
Babette Vương Thành=vương thành Ba Bối Đặc
Babette thành=thành Ba Bối Đặc
Ernst Kan vương quốc=vương quốc Ân Tư Khảm
U Chi Sâm=U Chi Sâm
hỏa đằng=Hỏa Đằng
Tinh Linh nhất tộc=tộc Tinh Linh
Tinh Linh=Tinh Linh
đại đinh thành=thành Đại Đinh
bãi bồi thành=thành Bãi Bồi 
Du nguyên thành=thành Du Nguyên
Ổ áo lót thành=thành Tùng Sào
ổ cây thông thành=thành Tùng Sào
Nori=Tử Vy
Tinh Linh nữ vương=nữ vương Tinh Linh
Tinh Linh Tộc=tộc Tinh Linh
Sicily=Tây Tây Lý
Fei=Phi Phi
Fei Đại Pháp Sư=Phi Phi Đại Pháp Sư
Tinh Linh chi sâm=Tinh Linh Chi Sâm
u chi sâm lâm=Rừng U Chi Sâm
Không Gian lóe lên=Ám Ảnh Nhảy Vọt
đầu bếp đại tái=Cuộc Thi Đầu Bếp
bác lập nạp thành=thành Bác Lập Nạp
Đinh đạt đến du thành=thành Đinh Đạt
gấp mười lần cực tốc=Chạy Nhanh Gấp 10 Lần
Bồ Đề trà=Trà Bồ Đề
trăm Trà Hoa=Trà Trăm Hoa
trân cao ngất cửa hàng=Cửa hàng Bánh Ngọt Huyền Vũ
Hoa Ngôi Sao trà=Trà Hoa Ngôi Sao
phòng theo dõi=Phòng Quan Sát
giam khống thất=Phòng Quan Sát
bỏng ngô=bắp rang
cửu tinh lầu=Cửu Tinh Lâu
Lục Tinh lầu=Lục Tinh Lâu
Ma Pháp Sư hiệp hội=Hiệp Hội Ma Pháp Sư
Lam Khê=Lam Khê
thưởng thức trà hội=tiệc trà xã giao
Ái Hoa=Ái Hoa
yêu tỷ=Ái tỷ
Thưởng thức trà biết=tiệc trà xã giao
Mua sắm tiết=Tuần Lễ Mua Sắm
thiếu nữ yêu đương nhật ký=Nhật ký yêu đương của thiếu nữ
giám sát máy thu hình=Máy Quay Giám Sát
giám sát linh khí=Máy Quay Giám Sát
Thị trường nhân tài=Trung Tâm Giới Thiệu Việc Làm
Đột Kích Đội=Đội Đột Kích
nguyên tố nước Lĩnh Vực=Lĩnh Vực Nguyên Tố Nước
Tinh Long ngư=Tinh Long Ngư
Tinh Long cá=Tinh Long Ngư
Phượng Thụ=Cây Phượng Hoàng
Tứ Nhĩ Kim Lưu Thú=Thú Kim Lưu Bốn Tai
Lục Giác Thị Huyết Trùng=Trùng Hút Máu Sáu Sừng
Foertsch vương quốc=vương quốc Phúc Nhĩ Kỳ
Bá Lệ công tước=công tước Bá Lệ
Phi hành giày=Giày Bay
phản trọng lực đạn=đạn phản trọng lực
tróc nã đạn=đạn tróc nã
Tuyết Diệp=Tuyết Diệp
Mua máu chứng=giấy phép mua máu
Bố lập lang=Bố Lập Lang
bố lập lãng=Bố Lập Lang
Tuyết Tạc=Tuyết Diệp
hãng chế thuốc=Xưởng Chế Thuốc
Tào ngươi sâm=Tào Nhĩ Sâm
Bố Ân thành=thành Bố Ân
phu âu thành=thành Phu Âu
Kain thành=thành Bố Y
Y lạc thành=thành Y Lạc
sóng mẫu thành=thành Ba Mẫu
ba mẫu thành=thành Ba Mẫu
Y Hộ Binh=Quân Y
y viện=Bệnh Viện Đa Khoa 
Hỉ Na=Hỉ Na
Tinh Hồng văn lộ=hoa văn đỏ đen
đề đề=Đề Đề
Aino=Ngải Ni
Ngải lạc=Ngải Ni
Bran đế=Bạch Lan
đại tông hậu cần=đại tông hậu cần
lục biên khiên=Khiên Sáu Cạnh
gatling=Súng Nòng Xoay
xưởng quân sự=Phường Công nghiệp Quân Sự
nhiễm môi ma dược=ma dược nhuộm môi
đẹp trang tiệm=cửa hàng trang điểm
thi đấu La=La Đấu
Lộ Lộ=Lộ Lộ
An Lệ=An Lệ
á thi đấu làm=Tố Châu 
Tố Châu vương quốc=vương quốc Tố Châu
khoa kỳ=Khoa Kỳ
Tuyết Thành=Thành Tuyết
Ra Sao từ=Thiệu Tông
Cái gì từ=Thiệu Tông
Hà Do=Thiệu Tông
Thẩm Mỹ Viện=Thẩm Mỹ Viện
tiệm thẩm mỹ=Thẩm Mỹ Viện
hoa trà=Trà Hoa
Lôi Nặc=Lôi Nặc
Troy=Đặc Y
Rhine=Nhân Hà
Nguyên Tử=Nguyên Tử
ma pháp thạch=Đá Ma Pháp
Hỗn Độn ma pháp=ma pháp Hỗn Độn
Teller=Ngải Luân
ma cụ thành=Trung tâm buôn bán ma cụ
một vô lại Đại Sư=đại sư Ác Côn
"Hư" huyết ước số= Hư Huyết 
thiên hư dạy=Thiên Hư Giáo
Noth=Nặc Tư
Roy=La Y
Lohr=Lạc Nhĩ
ác sở tàn sát=Ác Cơ Tử
Thiên hư giáo=Thiên Hư Giáo
Josie khắc thành=thành Kiều Tây Khắc
Linh Hồn Độc Tố=Linh Hồn Độc Tố
Bách Túc Ngô Công=Rết Trăm Chân
Hèn mọn Huyết Thực=Huyết Thực hèn mọn
hư tứ vương=Hư Tứ Vương
Hư lục Vương=Hư Lục Vương
Hư bát Vương=Hư Bát Vương
Hư Cửu Vương=Hư Cửu Vương
Thập Vạn Đại Sơn=Thập Vạn Đại Sơn
Hư Quỷ Hoàng=Hư Quỷ Hoàng
hư tộc=Hư Tộc
Truyền Tống Môn=Cửa Truyền Tống
khổng lồ hoá=Khổng Lồ Hoá
Bốn tai kim lưu thú=Thú Kim Lưu Bốn Tai
sơ đại lão tổ=lão tổ sơ đại
Không gian Truyền Tống Môn=Cửa Không Gian Truyền Tống
Không gian Cửa Truyền Tống=Cửa Không Gian Truyền Tống
Phất thất=Phất Thất
Đại La=Đại La
Lai Vu=Lai Vu
Nại Hỏa Thạch=Đá Chịu Nhiệt
dạ có=Dạ Khả
Hư Quỷ Vương=Vua Hư Quỷ
cát bên phải=Sa Hữu
Á Kỳ=Á Kỳ
vân mây=Vân Vân
hắc Thiết Sơn=núi Hắc Thiết
vương thành=vương thành
nhu hà=Nhu Hà
Hồ ly hà=Hồ Ly Hà
Hồ ly ngươi=Hồ Ly Nhĩ
Hồ ly y theo=Hồ Ly Y Y
hoành y sơn mạch=Dãy Núi Hoành Y
không gian truyền tống ma pháp trận=ma pháp trận không gian truyền tống
gió Hải vương quốc=vương quốc Phong Hải
Hồng âu thành=thành Hồng Âu
Sa ni=Sa Ni
Cam đừng=Cam Mạc
Cam chớ=Cam Mạc
nhảy nước=nhảy cầu
thể dục quán=hội quán thể dục
mười dặm sơn mạch=Dãy Núi Mười Dặm
phú năng trân châu=Phú Năng Trân Châu
Hương liễu quả=Quả Hương Liễu
băng đường hồ lô=kẹo hồ lô
tiêu diệt vũ khí=vũ khí tiêu diệt
Silena=Tây Lệ Na
Không Gian Khiêu Dược=Không Gian Thiểm Thước
Lôi Đình kiếm=Lôi Đình Kiếm
nhiều lê=Đa Lê
lê Mạch Thành=thành Lê Mạch
Tị Độc bí dược=bí dược Tị Độc
Khải Na=Khải Na
cao giá đường=đường giao thông trên cao
Lôi xạ pháo=Lôi Xạ Pháo
ma thú tài liệu=tài liệu ma thú
ba hợi thành=thành Sóng Nhĩ
Cày máy móc=máy cày
Hư Quỷ kiểm tra đo lường linh khí=linh khí kiểm tra đo lường Hư Quỷ
Hư Quỷ Lĩnh Vực=Lĩnh Vực Hư Quỷ
hư hai=Hư Nhị
Hư nhị=Hư Nhị
hư tám=Hư Bát
Hư bát=Hư Bát
hắc tuyến hoa=Hoa Sọc Đen
đề đâu thành=thành Đề Nhĩ
Tello ngươi thành=thành Cáo Nhĩ
hải giang quốc vương=quốc vương Hải Đinh
Sơ đầu quả tim=Lưu Tâm
Sơ tâm=Lưu Tâm
Sóng hợi thành=thành Sóng Nhĩ
tiên Tuyết Hồ=Hồ Ly Tuyết
nghỉ đặc biệt vương quốc=vương quốc Đặc Giả Kỳ
Huyền Điểu Thú Vương=Thú Vương Huyền Điểu
Hư Quỷ cấm chế=Cấm Chế Hư Quỷ
trọng lực ức chế trường thương=Thương Ức Chế Trọng Lực
Trọng lực ức chế chi thương=Thương Ức Chế Trọng Lực
trại trưởng=doanh trưởng
quang hệ linh khí pháo=linh khí pháo hệ quang
Phong Cấm vũ khí=vũ khí Phong Cấm
số 2 vũ khí Phong Cấm=vũ khí Phong Cấm số hai
phản kỳ thị pháp=luật chống phân biệt đối xử
Hắc Hổ Thống Lĩnh=Thống Lĩnh Hắc Hổ
đầu heo Thống Lĩnh=Thống Lĩnh Đầu Heo
Man Ngưu Thống Lĩnh=Thống Lĩnh Man Ngưu
Độc Xà Thống Lĩnh=Thống Lĩnh Độc Xà
Huyết Thực=Huyết Thực
Tám Lần Cực Tốc=Chạy Nhanh Gấp 8 Lần
Elle=Ngải Lỵ Na
Flaglo=Phất Lai Cách Lạc
Phật Legg lạc=Phất Lai Cách Lạc
Thám Hiểm Gia=thợ săn thám hiểm
Tô cùng là=Tô Liễu
Nhược hóa Lĩnh Vực=Lĩnh Vực Suy Yếu
Lam Ngân đồng cỏ và nguồn nước=Cỏ Nước Lam Ngân
Lam Ngân Thủy Thảo=Cỏ Nước Lam Ngân
Hải Hà quốc vương=quốc vương Hải Đinh
Hỏa thành=thành Hỏa
hỏa dịch thành=thành Hỏa
Hỏa tới thành=thành Hỏa
Kempins=Khải Tân Tư
Hắc Két=Hắc Két
Salo=Tát Lạc
Nay nay=Bối Bối
Thông quan hộ chiếu=Hộ Chiếu Thông Quan
Linh câu=Linh Tịch
tai cụp lông tơ thỏ=Thỏ Tai Cụp Lông Nhung
Chan đầu khớp xương=canh xí quách
chân ngưu thú=Trâu Tám Chân
bát cước ngưu thú=Trâu Tám Chân
Thống Lĩnh=Thống Lĩnh
Hắc Ma Chu=Hắc Ma Chu
Hắc Ma Thương=Hắc Ma Thương
Bích Hà=Bích Hà
sương tay=Sương Tây
Nặc Nhi=Nặc Nhi
Zener=Tề Nhĩ Lạp
á Thanh Thành=thành Á Thanh
Lirina=Lỵ Lỵ
mỹ á vương quốc=vương quốc Mỹ Á
Khải Kha Phu=Khải Kha Phu
Kỳ Lộ=Kỳ Lộ
Ada Bamboo=A Đát Trúc
chịu tồn trữ chất thuốc=Thuốc Bảo Quản
Chịu tồn trữ dược tề=Thuốc Bảo Quản
nhãn dược thủy=thuốc nhỏ mắt
Thiên Sứ Chi Lệ=Nước Mắt Thiên Sứ
thang có tay vịn tự động=Thang Cuốn
Ẩn thân khắc tinh=Khắc Tinh Ẩn Thân
Điện lực động cơ=Động Cơ Điện Lực
Ti An=Ti An
tạo thuyền nhà xưởng=Xưởng Đóng Tàu
17 đạo minh=Thập Thất Đạo Minh
Hải thở dài=Hải Thán
Sinh Mạng Rượu Hoa=Rượu Hoa Sinh Mệnh
Lạc Hải vương quốc=vương quốc Lạc Hải
Lãnh vung vương quốc=vương quốc Lãnh Vung
Thép Tím khôi giáp=Khôi Giáp Thép Tím
sinh mệnh Rượu Hoa=Rượu Hoa Sinh Mệnh
huyền hơi thở thác=Huyền Bố Thác
Amos=A Mạc Tư
Bruce=Bố Lỗ Tư
Erlangen=Ái Nhĩ Cang 
hồng Thạch vương quốc=vương quốc Hồng Thạch
Khắc Lập=Khắc Lập
Flaig lạc=Phất Lai Cách Lạc
Khoái Bào Vịt=Vịt Chạy Nhanh
phi hành Kỵ Sĩ=Kỵ Sĩ Phi Hành
Kina=Khải Na
Megan=Mai Căn
Yijou=Y Vưu
Sally=Ti Toa Lệ
vương quốc Huyền Vũ hiến pháp=hiến pháp vương quốc Huyền Vũ
tám vân lúc lưu thú=Thú Điều Khiển Thời Gian Tám Vằn
Augsbur=Áo Cách Tư Cách
thuần dưỡng thú=thú thuần dưỡng
Hải Chi Khải=Hải Chi Khải
binh lính nhóm=nhóm binh lính
duyệt binh nghi thức=nghi thức duyệt binh
Luyện Tập Thất=phòng luyện tập
Hắc Mộc=Gỗ Mun
vân tay tro=Vân Tro
ám ảnh bộ giáp=Khôi Giáp Ám Ảnh
Phi Ngô=Phi Ngô
ma sông đại thành=thành Ma Hà
thanh ma chim=Chim Quỷ Xanh
Hà Lạc=Hà Lạc
hồng lập=Hồng Lập
tạt nước tiết=Lễ Hội Té Nước
mỹ thực tiết=Lễ Hội Mỹ Thực
rượu tiết=Lễ Hội Rượu
bia tiết=Lễ Hội Rượu
vương thất quý tộc=vương thất quý tộc
Linh thực cửa hàng=Cửa Hàng Linh Thực
Ruud=Lộ Đức
kiều Lâm=Kiều Lâm
kiến quốc đại điển=đại điển kiến quốc
trần lỗ hổng=Trần Khổng
Mạo Hiểm Gia=Nhà Mạo Hiểm
Nhu Nhi=Nhu Nhi
Norman=Nặc Mạn
Denis=Đan Ni tư
Ước Mỗ=Ước Mỗ
Linh tịch=Linh Tịch
Michelle=Mễ Hiết Nhĩ
Tạo thuyền nhà xưởng=Xưởng Đóng Thuyền
Tiêu Khắc đại thành=thành Tiêu Khắc
kẹo cửa hàng=cửa hàng bánh kẹo
nướng thịt tiệm=tiệm thịt nướng
hỏa oa điếm=tiệm lẩu
Mesak=Mai Tát Khắc
số mười một Vệ Thành=Vệ Thành Số Mười Một
Na tử=Na Tử
bão táp hải=vùng biển bão táp
An Toàn Bộ=bộ an toàn
xây thành bộ=bộ xây dựng
nâng lạt=Nâng Lạt
Dalla mã=Đạt Lạp Mã
Bằng lòng á=Bằng Á
Trường kỹ thuật=Trường Kỹ Thuật
trường chuyên nghiệp=Trường Kỹ Thuật
Chức nghiệp học viện=Trường Kỹ Thuật
ngàn cức=Thiên Cức
Thiên Cức Thành Buôn Bán=Thành Buôn Bán Thiên Cức 
Phượng cây=Cây Phượng Hoàng
hành hoang thương nhân=thương nhân hành hoang
Máu Độc khống chế=Khống Chế Máu Độc
Huyết Độc=Máu Độc
Lục giác nghiện Huyết Trùng=Trùng Hút Máu Sáu Sừng
Sơn Hải Thành Buôn Bán=Thành Buôn Bán Sơn Hải
Buôn Bán thành=Thành Buôn Bán
Bạch Linh thú=Thú Bạch Linh 
ám ảnh tơ nhện=Tơ Nhện Ám Ảnh
Gợi ý của hệ thống giọng nói=Âm thanh nhắc nhở của hệ thống
Thang Vận Chuyển=Thang Vận Chuyển
quản lý cục=Cục Quản Lý
không gian mang theo người=không gian tùy thân
bình thủy tinh=bình lưu ly
bên trong thành=Nội Thành
ngoài thành=Ngoại Thành
tiểu hình phi thuyền vận chuyển=phi thuyền vận chuyển cỡ nhỏ
chủ thành=Chủ Thành
Hình thể biến ảo=Biến Ảo Hình Thể
năng lực giác tỉnh=năng lực thức tỉnh
tiệm đồ uống lạnh=Tiệm Đồ Uống Lạnh
Tát vui phân=Tát Nhạc Phân
Nguyệt Dạ thành=thành Dạ Nguyệt
Thành Chủ Đại Nhân=thành chủ đại nhân
ám ảnh nhảy=Nhảy Vọt Ám Ảnh
ám ảnh nhún nhảy=Nhảy Vọt Ám Ảnh
Cự Kìm Kiến=Kiến Gọng Kìm
phi hành tọa yên=yên phi hành
liên lạc thất=Phòng Liên Lạc
Cự Xà=rắn khổng lồ
vạn Cức tốn=Hoa Vạn Gai 
Siphoa=Tây Phổ Hoa
in nhà xưởng=Xưởng In
Galileo=Già Lực Lỗ
phú có thể trân châu=Phú Năng Trân Châu
Ma Thú=ma thú
lục quân=Lục Quân
Vệ Thành quản để ý cục=Cục Quản Lý Vệ Thành
Huyết Nguyệt phủ xuống=Huyết Nguyệt buông xuống
Dos=Đa Tư
Tinh Thần Thụ=Trà Thụ Tinh Thần
cửu nhãn thú=Thú Nhân Bản
Xe Lửa Quỹ=đường ray xe lửa
Bellian=Bối Nhĩ Liên
Thiên Vương sơn=Ong Chúa
Thiên Vương Phong=Ong Chúa
Khế Ước Cảm Ứng=Khế Ước Cảm Ứng
Cary=Tạp Lý
Elina=Ngải Lỵ Na
tạo thuyền nhà xưởng=Xưởng Đóng Thuyền
Cự Long=Rồng Khổng Lồ
đại nhà tắm=Nhà Tắm Công Cộng
Gà chiên tiệm=Cửa hàng Gà Rán
bánh bao nhân thịt=hamburger 
Phi ngư vương=Vua Cá Chuồn
Naan=Na An
Aliya=Lê Nhã
Alinos=Lê Tuyết 
Gallo=Già Lạc
già lạc=Già Lạc
Quáng xa=xe chở khoáng thạch
công nghiệp quân sự phường=Phường Công nghiệp Quân Sự
Trần không=Trần Không
quán mì=Tiệm mỳ chua cay
Ma Lực=ma lực
hút máu Quỷ=Ma Cà Rồng
hỗn huyết ma cà rồng=Ma Cà Rồng lai
Mét Nghỉ=Mặc Nghi
Road=Lộ Phát
Lưu Ly=lưu ly
lục túc thú=Thú Sáu Chân
Founa=Phất Âu Nạp
Nguyệt Dạ=Dạ Nguyệt
Jiisu=Dạ Nguyệt Cát Tư
Leopolo=Áo Lợi Ba
Oris=Áo Lợi Tư
Thư Ký=thư ký
ngắm cảnh xe lửa=xe lửa ngắm cảnh
dưới đất tình báo thương nhân=thương nhân tình báo ngầm
Chiller=Chi Lê
Cự Nỗ=Nỏ Lớn
tự thân tứ duy thuộc tính=thuộc tính bốn chiều của mình
tứ duy bảng skills=giao diện thuộc tính bốn chiều của mình
Long Ỷ=long ỷ
quản để ý cục=Cục Quản Lý
quyền kích=quyền anh
quyền anh lôi đài=lôi đài quyền anh
Quyền anh Thủ bộ=đồ bảo hộ quyền anh
quyền anh quán=Hội Quán Quyền Anh
Tư Khải đông=Tư Khải Đông
tiểu nặc=Tiểu Nặc
nhà hàng=nhà ăn
Mya=Mễ Á
Midi=Mai Dĩ
Kim Mao Vịt=Vịt Lông Vàng 
xưởng sắt thép=Xưởng Sắt Thép
Thanh Ma=Cua Quỷ Xanh
hồng kéo=khoai lang đỏ
huyễn Ảnh Ma pháp trận=ma pháp trận Huyễn Ảnh
miễn tai thiếu nữ=cô gái tai thỏ
Đại Ô Long=hiểu lầm tai hại
CMND=thẻ căn cước
Deas khắc=Khắc Đa
Cifer=Chi Phơ
Lina=Lý Nại
Gru=Giư
điện ảnh=phim điện ảnh 
Xem phim cần biết=Những điều cần biết khi xem phim
Ảnh đại sảnh=sảnh xem phim
Orna=Áo Nhĩ Na
Allman=Áo Nhĩ Mạn
Soho=So Hô
thông quan văn=Văn Điệp Thông Quan
hà phấn=hủ tiếu
tiến hóa điểm=điểm tiến hóa
Ám Nguyên Tố khống chế=Khống Chế Nguyên Tố Bóng Tối
Saler thành=thành Tát Luận
bán cao ốc bộ phận=Văn phòng mua bán bất động sản
trang phục thanh tú=Trình Diễn Thời Trang
Tạp hóa điếm=Cửa hàng Tạp Hóa
Tạp hóa tiệm=Cửa hàng Tạp Hóa
thiên ma tích	Rắn Mối Thiên Ma
trường mao hoả xà=Rắn Lửa Lông Dài
vụ thú=Mèo Sương Mù Tám Đuôi
huyền điểu thống lĩnh=thống lĩnh Huyền Điểu
Đầu chó Thống Lĩnh=thống lĩnh Đầu Chó
Sit=Xích
lục túc thú=Thú Sáu Chân
người thú vương quốc=vương quốc Người Thú
người thú Vương nước=vương quốc Người Thú
người thú Vương Thành=vương thành Người Thú
Horo vương quốc=vương quốc Hoa Rây
lắc mông=uốn éo
hoa tửu=Rượu Hoa
đừng cảnh=Đình Cảnh
Gray Keith=Cách Lôi Cơ Tư
Cách lai Keith=Cách Lôi Cơ Tư
Đạt đến tây đặc biệt vương quốc=vương quốc Đạt Tư
Lộc ấp vương quốc=vương quốc Lộc Ấp
Lê suối vương quốc=vương quốc Lê Tuyền
bạo tạc quả=Măng Cụt Bom
Bạo Tạc Thụ=Măng Cụt Bom
Katya=Tạp Giai
Hải Quân Cơ Địa=căn cứ Hải Quân
David thành=Vệ Thành
Phi Thuyền tràng=bãi đậu phi thuyền
Trượt tuyết tràng=sân trượt tuyết
trượt băng tràng=sân trượt băng
Sibeqi=Hi Bối Kỳ
Tây Betsy=Hi Bối Kỳ
lính phòng thủ thành=Thành Phòng Quân
Hoa Tuyết=bông tuyết
Sơn Hải buôn bán thành=Thành Buôn Bán Sơn Hải
Sơn Hải Quan buôn bán thành=Thành Buôn Bán Sơn Hải
Vô Lại Ngươi=Vô Lại Nhãn
số 12 Vệ Thành=Vệ Thành Số Mười Hai
số bảy Vệ Thành=Vệ Thành Số Bảy
Hải Quân Doanh=căn cứ Hải Quân
Nước mặn khu=Vùng Nước Mặn
y cày thành=thành Y Lê
Tát Lenl thành=thành Tát Luận
trấn nhỏ=thị trấn nhỏ
đáy biển thị trấn nhỏ=thị trấn nhỏ dưới đáy biển
Xe Lửa Quỹ=đường ray xe lửa
nhập quan giấy thông hành=Giấy Thông Hành Xuất Nhập Cảnh
giấy thông hành=giấy thông hành
Hải Quan đường biên giới=Biên Cảnh Hải Quan
Hải Quan biên cảnh=Biên Cảnh Hải Quan
Tân Đại Lục=đại lục mới
cơ thể người mới linh khí hóa thực nghiệm=Thí Nghiệm Linh Khí Cơ Thể Người mới
Morgan Stanley= Mô Gan Sa Lý
Đặc biệt hi đức=Hi Đức Vưu Kỳ
Đặc biệt Head=Hi Đức Vưu Kỳ
Bitcoin Head=Hi Đức Vưu Kỳ
Nghĩa nhi=Nghĩa Nhi
Nghĩa Địch=Nghĩa Địch
Đại Lệ Cô=Đại Lệ Cô
Đa mã=Đa Mã
Tử Văn quả=quả Tử Văn
Tử Văn cây=cây Tử Văn
thánh thành=Thánh Thành
ước bên trong=Ước Nội
bên trong ước= Ước Nội
Heather=Hi Sắt
Hiffany=Hi Phù Ni
Tesheed=Hi Đức Vưu Kỳ
Tehed=Hi Đức Vưu Kỳ
Hibaton=Hi Ba Tân
Mã Quyết=Mã Quyết
Chủ Quán=chủ quán
Safin=Sa Phiên
Phượng cây=Cây Phượng Hoàng
Vung diệp thành thú=Vung Lá Thành Thú
Vương Giai Ma Thú=ma thú Vương Giai
Sâm Nhân=Sâm Nhân
Tân Tây=Tân Tây
Hồng nham vương quốc=vương quốc Hồng Nham
Oman=A Mạn
không gian Bích Lũyt=tường rào không gian
lỗ đen trọng lực=Lỗ Đen Trọng Lực
cắn nuốt không gian=Cắn Nuốt Không Gian
Butixi=Bố Đề Tây
Thánh Phong=Thánh Phong
sinh mệnh nguyên quả=Quả Sinh Mệnh
miếng tinh thạch ma thú=viên tinh thạch ma thú
tề nhĩ nhiều Delhi=Tề Nhĩ Vô
Linh Vận=Linh Vận
Caligula=Kha Lý Gia
âm nhạc máy phát=Máy Phát Nhạc
Phượng nhi=Phượng Nhi
máy truyền hình=TV
ti vi=TV
Lam chấp sự=Lam chấp sự
Phượng, nhi=Phượng Nhi
thạch úc=Thạch Úc
Phó Kỵ Sĩ Trưởng=Phó Kỵ Sĩ Trưởng
giáp mảnh nhỏ=móng tay giả
Charles=Tra Nhĩ Tư
Tát vui phân=Tát Nhạc Phân
Bồ Đề cỏ=Cỏ Bồ Đề
Bồ Đề thảo=Cỏ Bồ Đề 
Sinh Mệnh Nguyên Tuyền=Suối Sinh Mệnh
Tam Hoa Đồng Linh Xà=Tam Hoa Đồng Linh Xà
Không Gian Khiêu Dược ma pháp=ma pháp Không Gian Khiêu Dược
hỏa xe=xe lửa 
Ô Quy=rùa đen
Vận nhi=Vận Nhi
Verissaya=Duy Lệ Á
Turan=Đồ Lan
trùng phao cà phê=cà phê uống liền 
tay vịn thê=thang cuốn
Điện trùng=Trùng Điện
chịu chứa đựng dược tề=thuốc bảo quản
ô tô=xe hơi
Tử Địch=Tử Địch Lệ
Sầm Phi Nhi=Cầm Phi Nhi
Mộng Phi Nhi=Cầm Phi Nhi
cao đẳng=cao cấp
xử phạt đơn=giấy xử phạt
quân kỷ quân quy=quân kỷ quân quy
Duy trì trật tự các binh lính=Các binh lính duy trì trật tự
Trấn đông bên trong trại lính=Bên trong Trấn Đông Quân Doanh 
trấn đông trại lính=Trấn Đông Quân Doanh
Trấn đông trại lính=Trấn Đông Quân Doanh
trấn đông Quân Doanh=Trấn Đông Quân Doanh
y học Sở Nghiên Cứu=Sở Nghiên Cứu Y Học
chiến đấu hầu gái=hầu gái chiến đấu
Hiệp Hội Ma Pháp Sư phân hội=phân hội Hiệp Hội Ma Pháp Sư 
Hi Sắt phân=Hi Sắt
Nhất hào ngục giam=Ngục Giam số một
Mây mù Linh Điền=Linh Điền mây mù
giám ngục=giám ngục
người thú vương thành=vương thành người thú
Trà Thụ Sinh Mệnh chi nhánh=cành cây Trà Thụ Sinh Mệnh
thuần huyết Ma Cà Rồng=Ma Cà Rồng thuần chủng
đội ám sát U Linh=Đội Ám Sát U Linh Chiến Thuật
Hải Đinh lão tổ=lão tổ Hải Đinh 
vương quốc Huyền Vũ Vương=quốc vương vương quốc Huyền Vũ
Tinh Thần lá trà=lá trà Tinh Thần
Giám sát Máy Quay Phim=Máy Quay Giám Sát
số sáu vệ thành=Vệ Thành Số Sáu
Bá Lệ=Bá Lệ
Foertsch=Phúc Nhĩ Kỳ
giáp ba đường phố=đường Giáp Thứ Ba
Hải Nguyệt vương quốc=vương quốc Hải Nguyệt
Nghê hồng quán rượu=quán rượu Nghê Hồng
màu đỏ rực tròng mắt=đôi mắt đỏ rực
Hải Đinh vương thất=vương thất Hải Đinh
một vô lại=Ác Côn
nhân thể thực nghiệm=thực nghiệm trên cơ thể người
người thể thực nghiệm=thực nghiệm trên cơ thể người
chân thành=nghiêm túc 
phim điện ảnh căn cứ=Phim Trường
trị thủ sĩ binh=binh sĩ canh gác
Hổ Đầu Thống Lĩnh=Thống Lĩnh Đầu Hổ
Ngưu Đầu Thống Lĩnh=Thống Lĩnh Đầu Trâu
lông thú bố=vải lông
Tằm Ti bố=vải tơ tằm
Bệ hạ vạn an=Bệ hạ vạn an
dệt nhà xưởng=Xưởng Dệt Vải
khéo léo=ngoan ngoãn
gió hải=Phong Hải
Phi điểu kỵ sĩ=Kỵ Sĩ Phi Điểu
miếng tinh thạch ma thú=viên tinh thạch ma thú
Nặng Công Nghiệp=công nghiệp nặng
người thú Vương nước=vương quốc Người Thú
Cày đao=dao cày
linh thực khu trồng trọt=khu trồng trọt linh thực
nghiện Huyết Trùng=Trùng Hút Máu
ma pháp không gian Sư=Ma Pháp Sư hệ Không Gian
người thú vương quốc=vương quốc Người Thú
Đại An Tis=Đại An Ti
Lan Lư Ba vương quốc=vương quốc Lan Lư Ba
in nhà xưởng ấn=Xưởng In Ấn
Khu Vực Trung Ương bọn hộ vệ=nhóm hộ vệ Trung Ương
Khu Vực Trung Ương tầng tám=tầng tám Khu Vực Trung Ương
Verissaya=Duy Lệ Á
ảnh thị thành=Phim Trường
quang nguyên tố=nguyên tố ánh sáng
không gian chứa đựng ma cụ=ma cụ không gian chứa đựng
tiểu meo=Tiểu Miêu
Thép Tím khu mỏ quặng=khu mỏ quặng Thép Tím
phân hội trưởng=hội trưởng chi nhánh
Thể Linh khí hóa kế hoạch=Kế hoạch Thí Nghiệm Linh Khí Cơ Thể Người
Đời thứ hai hình người Linh khí=Linh khí hình người đời thứ hai
Linh Khí Cơ Thể Người kế hoạch=Thí Nghiệm Linh Khí Cơ Thể Người
Chí Hải trưởng lão=trưởng lão Chí Hải
Gió Vũ trưởng lão=trưởng lão Phong Vũ
Durham=Đức Luân
onii Dương=Âu Ni Dương
Lục Mặc tử tước=tử tước Lục Mặc
ám nguyên tố khống chế=Khống chế nguyên tố bóng tối
quân sự diễn luyện=diễn luyện quân sự
quả sinh mạng=quả Sinh Mệnh
cao nguyên hộ vệ=hộ vệ Trung Ương
Landy=Lan Đế
Quỷ ảnh nhện=Nhện Quỷ Ảnh
Tây Hoa Vương Thành=vương thành Tây Hoa
Thép Tím khoáng=khoáng thạch Thép Tím
Lan lư sóng=Lan Lư Ba
ma thú triều=thủy triều ma thú
Nhị bảo rượu=Rượu Nhị Bảo
Một bảo rượu=Rượu Nhất Bảo
cỡ nhỏ phi thuyền vận chuyển=phi thuyền vận chuyển cỡ nhỏ
trung tâm phố buôn bán=Phố Buôn Bán trung tâm
cất rượu nhà xưởng=Xưởng Chưng Cất Rượu
cất rượu công xưởng=Xưởng Chưng Cất Rượu
Tát luận ngươi thành=thành Tát Luận
Daulle la=Đa Lai La
Mang an=Đái An
Hồng Chấp Sự=Hồng chấp sự
Tử Chấp Sự=Tử chấp sự
hải đinh quốc vương=quốc vương Hải Đinh
sinh mệnh quả=Quả Sinh Mệnh
con rối hộ vệ=Con Rối Hộ Vệ
thất nhãn thú=Thú Bảy Mắt
Thú Sương Mù Tám Đuôi=Mèo Sương Mù Tám Đuôi
vụ thú=Mèo Sương Mù Tám Đuôi
Sinh mệnh chi tuyền=Nước Suối Sinh Mệnh
Dụ Phi Nhi=Dụ Phong Nhi
vũ gió=Vũ Phong
ma cụ cửa hàng=Cửa Hàng Ma Cụ
Kỵ Sĩ trưởng=Kỵ Sĩ Trưởng
cảnh xan thú=Thao Thiết
hải đinh vương quốc=vương quốc Hải Đinh
sương trắng=Bạch Sương
dụ chính cửa hàng=hiệu buôn Dụ Chính
ma thú trong tinh thạch=trong tinh thạch ma thú
Nguyệt thấm mắt xanh=Nguyệt Thấm Lan
nguyên tố sinh mệnh tinh linh=Tinh Linh Sinh Mệnh
La nại=La Na
chiêm bặc sư=Nhà Bói Toán
Raya=Lạp Nhã
thủy thần khôi giáp=Khôi Giáp Thủy Thần
Hồng chấp sự=Hồng chấp sự
Lục chấp sự=Lục chấp sự
Hắc Ma Pháp Sư=Hắc Ma Pháp Sư
Ba Phù=Ba Phù 
đài ngắm trăng=sân ga
Hải yêu=Hải Yêu
trân bảo lầu=Trân Bảo Lâu
mới Phố Buôn Bán=Phố Buôn Bán mới
Huyền Vũ tửu lầu=Trung tâm Huyền Vũ
Huyền Vũ tửu lâu=Trung tâm Huyền Vũ
cũ đại lục=đại lục cũ
Sói mặt trăng nhóm=bầy Sói Mặt Trăng
tiệm bán dầu thơm=Cửa Hàng Nước Hoa
tóc vàng trứng vịt=trứng Vịt Lông Vàng
Bé Gái Cát Toa=Ny Cát Sa
mây nghe=Vân Hân
Camino=Mễ Nặc
làm tô=Tố Tô
chiếu minh thạch=Đá Phát Sáng
kim huyết thảo=Cỏ Máu Vàng
thị trường giao dịch=Chợ Giao Dịch
cầu vồng huyết thạch=Đá Cầu Vồng Máu
Ly Trăng=Ly Nguyệt
Pháp Jason=Pháp Kiệt Sâm
Euphe nhi=Vưu Phi Nhi
Vũ Đồ=Vũ Đồ
Đồ Lan=Đồ Lan
Đồ Lan rượu=rượu Đồ Lan
Tàng Thư=Tàng Thư
tàng thư điện=điện Tàng Thư
đá ma pháp=Đá Ma Pháp
Chợ Nô Lệ=Chợ Nô Lệ
Mê Vụ Hải=Kênh Sương Mù
tây phong thành=Thành Tây Phong
Luyện Dược Sư=Luyện Dược Sư
Ma Hóa Ma Dược=Ma Dược Ma Hóa
không gian ma cụ=ma cụ không gian
không gian ma pháp=ma pháp không gian
hộ vệ đội=đội hộ vệ
ma pháp sư nhóm=nhóm Ma Pháp Sư
kỵ sĩ đoàn=đoàn Kỵ Sĩ
dụ thú mồi=Mồi Dụ Thú
cầm máu ma dược=Ma Dược Cầm Máu
đội mạo hiểm=đội mạo hiểm
nhà mạo hiểm=Nhà Mạo Hiểm
Thiết Lan quán rượu=quán rượu Thiết Lan
Hải Thần Che Chở=Hải Thần Che Chở
Áo Thác vương quốc=vương quốc Áo Thác
Trà Tề Quốc=vương quốc Trà Tề
Sa quốc=vương quốc Sa
đại đinh hải=biển Đại Đinh
tám đuôi u thú=Thú Sương Mù Tám Đuôi
Xóm nghèo=Khu Ổ Chuột
thủy thần khôi giáp=Khôi Giáp Thủy Thần
trồng trọt khu=khu trồng trọt
lôi đình khôi giáp=Khôi Giáp Lôi Đình
con rối cây=Con Rối Hộ Vệ 
Dụ bắt thảo=Nắp Ấm Dụ Dỗ 
Hoa Sương Mê phấn=Phấn Hoa Mê Man
yến hội sảnh=sảnh yến hội
Đại Mễ Phạn=cơm trắng
mộng ảo sương mù=Sương Mù Mộng Ảo
Vệ Thành=Vệ Thành
Sinh Mệnh Thụ=Trà Thụ Sinh Mệnh
Sinh Mệnh Lĩnh Vực=Lĩnh Vực Sinh Mệnh
Sinh Mệnh Nguyên Trà=Trà Sinh Mệnh
Sói Mặt Trăng Vương=Vua Sói Mặt Trăng
Quỷ Ảnh Trỉ Chu=Nhện Quỷ Ảnh
Hải Giang vương quốc=vương quốc Hải Đinh
Trọng lực vặn vẹo=Vặn Vẹo Trọng Lực
phi hành linh khí=linh khí phi hành
Thập Đầu Xà Hình Thái=Rắn Mười Đầu
Mộc Nghĩ Thái=Ngụy Trang Hình Thái
Vạn Cức Hoa=Hoa Vạn Gai
Mộng Huyễn Mê Vụ=Sương Mù Mộng Ảo
thành Tương Lai Đại trường lão= Đại trường lão thành Tương Lai
Táng Kình=Cá Nhà Táng
Nhân thể Linh khí hóa=Linh Khí Cơ Thể Người
Bố Vi Nhi=Bối Vi Nhân
Tứ Nhĩ Thú=Thú Bốn Tai
Lê Bỉ=Thử Bỉ
kịch bản luyện tập phòng=phòng luyện tập kịch
Táng Cốc=Cốc Táng
linh khí đại bác=Linh khí đại pháo
Ốc Đảo Tam trưởng lão=Tam trưởng lão Ốc Đảo
chính án=chánh án
Nghiêu Thiên tổ chức=tổ chức Nghiêu Thiên
Bắc Hải đường=Bắc Hải Đường
Bắc Hải Đường lão bản=Chủ tiệm Bắc Hải Đường
dưới mặt đất tình báo thương nhân=thương nhân tình báo ngầm
Tân Luật Pháp=Luật Pháp Mới
nhà máy xử lý nước thải=Nhà Máy Xử Lý Nước Thải
pháp viện=Tòa Án
Y Lệ Y lão sư=Lão sư Y Lệ Y
tiệm thuốc=Nhà Thuốc
phi long=Rồng Bay
thạch hóa nhãn=Mắt Hóa Đá
Vô Hạn Tiến Hóa=Vô Hạn Tiến Hóa
Vô Hạn Long quả=Vô Hạn Long Quả
vô hạn Long Thụ=Vô Hạn Long Thụ
dung nham thổ tức=Hơi Thở Dung Nham
dung nham thiên tai=Thiên Tai Dung Nham
tiệm mì=Tiệm Mì
tiệm bán quần áo=cửa hàng Vải Và Trang Phục
thành Huyền Vũ pháp luật pháp quy=pháp luật pháp quy thành Huyền Vũ
Thủ hộ linh thú=Linh Thú Thủ Hộ
Thánh Thụ=Thánh Thụ
Cảm Giác Nguy Hiểm=Cảm Giác Nguy Hiểm
Tái Sinh Xương Cốt=Tái Sinh Xương Cốt
Lân Giáp Tàng Hình=Lân Giáp Tàng Hình
tiểu hải=Tiểu Hải
cá chuồn vương=Vua Cá Chuồn
long chủ=Long Chủ
ấu long=rồng con
Quỷ Ảnh Tri Chu=Nhện Quỷ Ảnh
Thiên Ảnh tơ nhện=Tơ Nhện Thiên Ảnh
Nham Tương Hỏa Long=Rồng Lửa Dung Nham
long chi thổ tức=Hơi Thở Của Rồng
biển sâu cự yêu=Cự Yêu Biển Sâu
cắn nuốt không gian=Không Gian Cắn Nuốt
thao thiết thú=Thao Thiết
Quỷ Dị Trùng=Trùng Quỷ Dị
Người cá chiến sĩ=chiến sĩ Người Cá
Phó thủ vệ trưởng=phó đội trưởng
người cá tộc=tộc Người Cá
cửu thải sắc lân giáp=lân giáp chín màu
Cửu Thải Tích Dịch=Kỳ Nhông Chín Màu
dị xà=Rắn Biến Dị
Quang minh thú=Thú Ánh Sáng
Thông Tấn Trung Tâm Hệ Thống=Hệ thống Trung tâm thông tin
tiểu bàn=Tiểu Béo 
tấn thăng khảo thí=thi thăng cấp
Hoang Cổ Hải Thú=Hải Thú Hoang Cổ
nhân ngư đảo=đảo Nhân Ngư
Thanh Ma Giải=Cua Quỷ Xanh
Thanh Ma khôi giáp=Khôi Giáp Thanh Ma
Cua Quỷ Xanh khôi giáp=Khôi Giáp Thanh Ma
Hắc thủy vân giao=Rồng Vân Mây Đen
Hắc thủy Vân Văn Giao=Rồng Vân Mây Đen
tây hiểu bộ lạc=bộ lạc Tây Hiểu
đấu giá hội=hội đấu giá
Đại Hội Đường=Đại Hội Đường
Nhân Ngư=Người Cá
lớn trưởng giả=Đại trưởng lão
tóc vàng vịt=Vịt Lông Vàng
hào hoa=cao cấp
may mắn thực chất bảo hộ=May Mắn Che Chở
Ngải Lệ Na=Ngải Lỵ Na
Angela=An Kiệt Lạp
ti Sally=Ti Toa Lệ
Hải Long Thú=Rồng Biển
hải hung thú=Hải Hung Thú
không gian lóe lên=Không Gian Thiểm Thước
Dị sắc trân châu=Trân châu dị sắc
Trân Châu Thú=Thú Trân Châu
ba nô=Ba Nô
tiệm sách=Tiệm Sách
toà báo=Tòa Soạn Báo
in ấn nhà xưởng=Xưởng In Ấn
dị biến=biến dị
đóng thuyền nhà xưởng=Xưởng Đóng Tàu
thiên sứ chi tráo=Đôi Cánh Thiên Sứ
Nuốt Chửng=Nuốt Chửng
May Mắn Che Chở=May Mắn Che Chở
hai trưởng giả=Nhị trưởng lão
phỉ nhi=Phi nhi
Thổ Thạch Phong=núi đá
liên lạc điểm=Điểm Liên Lạc
chủng thực khu=khu gieo trồng
hạ gia=nhà họ Hạ
chớ lên tiếng lĩnh vực=Lĩnh vực Im lặng
quy thuộc thành=thành quy thuộc
vạn khô lâm=Rừng Vạn Khô
Korff=Khoa Phu
nguyệt duy nhan=Nguyệt Phi Nhan
Hư Quỷ lây nhiễm=Hư Quỷ Cảm Nhiễm
kim phượng=Kim Phượng
khu giao dịch=khu giao dịch
Điện xà=Rắn Điện
lông vũ cánh hổ=Hổ Có Cánh
thủy tinh cá=Thủy Tinh Ngư
Vũ Thái trấn=trấn Vũ Thái
lơ lửng thú=Thú Phù Không
hổ tây=Hổ Tây
Vân thính=Vân Hân
Lina=Lỵ Lỵ
khu buôn bán=Phố Buôn Bán
sinh mệnh nguyên tố=nguyên tố sinh mệnh
Thu Lương=Mục Lương
Nguyệt duy nhan=Nguyệt Phi Nhan
trung chuyển căn cứ=căn cứ trung chuyển
vận chuyển phi thuyền=phi thuyền vận chuyển
a Thanh=A Thanh
tạo hóa Thanh Liên=Sen Xanh Tạo Hóa
Ba Đầu Sáu Tay=Ba Đầu Sáu Tay
tinh thể khống chế=Điều Khiển Tinh Thể
Thanh Sơ Thái=rau xanh
bốn thái thôn=thôn Tứ Thái
Tam Thái thôn=thôn Tam Thái
hai Thái thôn=thôn Nhị Thái
Nhất Thái thôn=thôn Nhất Thái
giác tỉnh giả=Giác Tỉnh Giả
bạch điêu=Chồn Trắng
Viện Mồ Côi=Viện Mồ Côi
Biến dị linh thú=Linh thú biến dị
lập lòe=Lấp Lánh
liên lạc phòng=Phòng Liên Lạc
Lông mày tổng trưởng=Đại tổng trưởng
nam phong thành=thành Nam Phong
nội thành phiên chợ=Chợ Đầu Mối
cấp tám Thủy Tinh Ngư=Thủy Tinh Ngư cấp 8
khu dân cư=Khu dân cư
mỏ muối=Mỏ muối
phân bón công xưởng=Xưởng phân bón
tòa báo=Toà Soạn Báo
Độc Giác Thú=Thú Một Sừng
Phi Nhi=Phi Nhi
người ăn trộm=đạo tặc
Âu Hòa=Âu Hòa
du sao=Du An
tiệm chụp hình=Tiệm Chụp Ảnh
máy chụp ảnh=Máy Chụp Ảnh
giá thành phí=Giá Thành Phí
không quân=Không Quân
Hải Quân=Hải Quân
Vũ Thái thành=thành Vũ Thái
Huyền Vũ ngục giam=Ngục Giam Huyền Vũ
làm việc đại sảnh=đại sảnh làm việc
nhà tù=Ngục Giam
Giam ngục=Ngục Giam
Huyết Nguyệt=Huyết Nguyệt
tam quan cứ điểm=tam quan cứ điểm
mưa mộng=Vũ Mộng
hắc thủy thành=thành Hắc Thủy
phong hành giả=Phong hành giả
đao khách=Đao khách
đồ long thợ săn=Thợ săn đồ long
Thánh Địa hội nghị=Hội Nghị Thánh Địa
Thánh Địa nghị hội=Hội Nghị Thánh Địa
Hư Quỷ Sào Huyệt=sào huyệt Hư Quỷ
cục quản lý=Cục Quản Lý
huyền vũ tệ=đồng Huyền Vũ
lông mày thống lĩnh=đại thống lĩnh
đàn vũ đại nhân=Cầm Vũ đại nhân
Hư Quỷ=Hư Quỷ
nhà xưởng khu=Khu vực Nhà xưởng
chế muối nhà xưởng=Xưởng Muối
chế đường nhà xưởng=Xưởng Đường
ép dầu nhà xưởng=Xưởng Ép Dầu
âm nhạc máy chiếu phim=Máy Phát Nhạc
Thức tỉnh năng lực=năng lực thức tỉnh
Khải Linh=khải linh
Già Lạc=Già Lạc
Ngọc Mễ Điềm canh=chè bắp
Địa Ma Viên=Vượn Quỷ Đất
Trường Tí Viên=Vượn Tay Dài
Bát Túc Ma Thiềm=Thiềm Thừ Tám Chân
nhập môn=sơ kỳ
lớn nhà tắm=Nhà Tắm Công Cộng
thánh giếng=Giếng Thánh
Diane ti=Đại An Ti
quân công quy định=chế độ quân công
 ong thợ= Ong Thợ 
cường hóa cơ thể bí dược=bí dược cường hóa cơ thể
Thất Thải Vân xà=Rắn Bảy Màu
Hoa Sinh Lạp=đậu phộng
Đồng ruộng người quản lý=người quản lý Đồng Ruộng
Đồng Ruộng=Đồng Ruộng
cà chua trứng tráng=trứng xào cà chua
Gà Ba Màu đản=trứng Gà Ba Màu
gà ba màu trứng=trứng Gà Ba Màu
tuyệt đối mệnh trung=Trúng Mục Tiêu
Trại Chăn Nuôi=Trại Chăn Nuôi
phi hành ngồi yên=Yên Bay
đầu tàu=xe lửa
Băng nhạc phát ra cơ=máy cát sét
Linh khí kho=Kho linh khí
Williams Duff=Tư Đạt Phu
Ngự Thổ thành=thành Ngự Thổ
hoa lão=Hoa lão
ngâm du thợ săn=thợ săn ngâm du
Hạ Lạp=Hạ Hạ
Nhân thể Linh khí hóa=Nhân thể Linh khí hóa
A đát trúc=A Đát Trúc
a tỷ trúc=A Đát Trúc
cường hóa cơ thể bí dược=bí dược cường hóa cơ thể
A Lê Nhã tỷ muội=chị em Lê Nhã
A Lê nhã=Lê Nhã
A Lê Tuyết=Lê Tuyết
thương khố=kho hàng
ngũ thải thằn lằn=Kỳ Nhông Năm Màu
hút âm thạch=Đá Hút Âm
Âm thạch=Đá Phát Âm
Huyền Vũ Chung=Chuông Huyền Vũ
Huyền Vũ chuông=Chuông Huyền Vũ
phi hành tọa kỵ=tọa kỵ phi hành
Không quân trụ sở=trụ sở Không quân
tầm bảo thợ săn=Thợ săn tầm bảo
Thái Căn=Thái Căn
Chitoge=Thiên Cức
Thiên Cức Quan=Thiên Cức Quan
Huyền Vũ Quan=Huyền Vũ Quan
Ngân Nguyệt Quan=Ngân Nguyệt Quan
Quỷ Minh Điểu=Quỷ Minh Điểu
bên phải hung thú tinh thạch=tinh thạch hung thú bên phải
Thái nhưng có thể=Thái Khả Khả
phi hành Linh khí=linh khí phi hành
Vận chuyển bậc thang=Thang Vận Chuyển
lơ lửng bãi đáp=mặt phẳng lơ lửng
lơ lửng bình đài=mặt phẳng lơ lửng
hung thú cốt=xương hung thú
kịch bản lão sư=giáo viên dạy kịch
mạo hiểm du ký=du ký mạo hiểm
Người Lòng Đất=Người Lòng Đất
đàn mưa=Cầm Vũ
thủy hàm khu=Khu vực nước mặn
Thủy hung thú=Thủy Hung Thú
hải hung thú=Hung Thú Biển
lục phù thú=Thú Lục Phù
Mục Lương tròng mắt màu đen=Đôi mắt đen nhánh của Mục Lương
Mục Lương đôi mắt thâm thúy=Đôi mắt thâm thúy của Mục Lương 
Mục Lương tròng mắt màu đen=Đôi mắt đen của Mục Lương 
Người Cá thiếu nữ=cô gái Người Cá
tóc màu quả quýt thiếu nữ=cô gái tóc màu quýt
Ma Cà Rồng thiếu nữ=cô gái Ma Cà Rồng
Ma Cà Rồng thiếu nữ=cô gái Ma Cà Rồng
thiếu nữ tai thỏ=cô gái tai thỏ
Tai thỏ thiếu nữ=cô gái tai thỏ
thiếu nữ tóc đỏ=cô gái tóc đỏ
tóc màu biếc thiếu nữ=cô gái tóc biếc
thiếu nữ tóc lục=cô gái tóc xanh lục
ưu nhã nữ nhân=cô gái ưu nhã
quyến rũ nữ nhân=cô gái quyến rũ
thiếu nữ tóc tím=cô gái tóc tím
thiếu nữ tóc cam=cô gái tóc cam
thiếu nữ tóc trắng=cô gái tóc trắng
thiếu nữ tóc vàng=cô gái tóc vàng
thiếu nữ tóc hồng=cô gái tóc hồng
tóc nâu thiếu nữ=cô gái tóc nâu
Tóc xanh thiếu nữ=cô gái tóc xanh
miêu nữ=cô gái tai mèo
xà nữ=cô gái người rắn
tóc bạc nữ nhân=cô gái tóc trắng
tóc xanh nữ nhân=cô gái tóc xanh
đuôi hồ ly nữ nhân=cô gái đuôi hồ ly
thiếu nữ tóc bạc=cô gái tóc trắng
Tóc cam thiếu nữ=cô gái tóc cam
nữ nhân tóc lục=cô gái tóc lục
miễn tai thiếu nữ=cô gái tai thỏ
báo nữ=cô gái người báo
mơ hồ thiếu nữ=cô gái mơ hồ
tinh linh thiếu nữ=cô gái tinh linh
tóc vàng song đuôi ngựa thiếu nữ=cô gái cột tóc hai chùm
Hải Yêu thiếu nữ=cô gái Hải Yêu
ngân phát nữ tử=cô gái tóc trắng
xanh phát nữ nhân=cô gái tóc xanh
sừng trâu thiếu nữ=cô gái sừng trâu
lập loè giáp trùng=Bọ Cánh Cứng Lấp Lánh
nổ tung tiễn=Tên Nổ Tung
ba nhét đan=Ba Tắc Đan
Thổ hệ Ma Pháp Sư=Ma Pháp Sư hệ Thổ
la mét thản=La Mễ Thản
Lợi khách tu=Lợi Khách Tu
mê vụ phấn hoa=Phấn Hoa Mê Man
Tiểu Ám=Tiểu Ám
Lan Lư Ba Vương Thất=vương thất Lan Lư Ba
Lan Lô Ba=Lan Lư Ba
cường hóa cơ thể bí dược=bí dược cường hóa cơ thể
cửu thải thằn lằn=Kỳ Nhông Chín Màu
phát sáng thạch=Đá Phát Sáng
Aure Na=Áo Nhĩ Na
Aure man=Áo Nhĩ Mạn
Tử Văn Khinh Cương=Thép Tím
Dededore=Đức Đức Đa Nhĩ Đàm
Juan thương hội=thương hội Hồ An
Y Nhĩ man thương hội=thương hội Y Nhĩ Mạn
Trương thúc=Trương thúc
Tô lâm y tưởng nhớ=Tô Lâm Y Tư
Tô lâm y nghĩ=Tô Lâm Y Tư
Đen lệ hoa=Hoa Hắc Lệ
giao dịch chợ=Chợ Giao Dịch
bằng hộ khu=Xóm Nghèo
Thiên môn trên lầu=Thiên Môn Lâu
Đại kỵ sĩ trưởng=Đại Kỵ Sĩ Trưởng
Chợ đen=Chợ Đen
tam giác thú=Thú Ba Sừng
không gian vặn vẹo=Vặn Vẹo Không Gian
nham giáp con rùa=Rùa Đen
Đa Tư quán rượu=Quán rượu Đa Tư
mạch tang công tước=công tước Mạch Tang
Mạch tang=Mạch Tang
Tam bảo rượu=Rượu Tam Bảo
Nhiều Stane=Đa Tư
Nhiều tư=Đa Tư
tử văn nhẹ thép=Thép Tím
Phòng Nghiên Cứu=Phòng Nghiên Cứu
cuồng hỉ=mừng như điên
cường hóa cơ thể bí dược=bí dược cường hóa cơ thể
lớn súp lơ=cải bông xanh
rộng thái=rau chân vịt
Bàn đạp xe gắn máy=Xe Máy
lông thú tuyến=sợi lông thú
dung nham cự long=Rồng Dung Nham Khổng Lồ
bát giác răng nanh thú=Lợn Tám Răng Nanh
Bàn Thú Một Sừng=Thú Sừng Mâm
bàn sừng thú=Thú Sừng Mâm
đàn mưa=Cầm Vũ
kỵ sĩ=Kỵ Sĩ
từ nóng một thể oa=nồi lẩu tự đun sôi
tiệm bán cù lao=Tiệm Lẩu
Cầm phi nhi=Cầm Phi Nhi
Ali lỗ=Già Lực Lỗ
Huyền Vũ tiệm lẩu=Tiệm Lẩu Huyền Vũ
dịch dùng oa=nồi lẩu
hỏa oa cửa hàng=Tiệm Lẩu
lan lư sóng vương quốc=vương quốc Lan Lư Ba
lan lư sóng quốc vương=quốc vương Lan Lư Ba
Y lê thành=thành Y Lê
ám nguyên tố khống chế=Khống Chế Nguyên Tố Ám
ám Ảnh Thú=Thú Ám Ảnh
u linh chiến thuật ám sát đội=đội ám sát U Linh
ám ảnh bộ đội đặc chủng=Bộ Đội Đặc Chủng Ám Ảnh
ám ảnh nhảy vọt=Nhảy Vọt Ám Ảnh
ám ảnh khôi giáp=Khôi Giáp Ám Ảnh
nô lệ thị trường=Chợ Nô Lệ
Cát liệt=Sa Liệt
hắc sa=Hắc Sa
long trà=Long Trà
Quỳ lâm nại=Quỳ Lâm Nại
Tiểu Kiều=Tiểu Kiều
hồ tiên=Hồ Tiên
Lắng Nghe Vạn Vật=Lắng Nghe Vạn Vật
thủy quân=Hải Quân
Thẹn đeo hộ vệ=Con Rối Hộ Vệ
Trấn Thiên Địa=Trấn Thiên Địa
trấn sơn thú=Thú Trấn Sơn
Điện mộng thú=Thú Điện Mộng
Ý Thức Cụ Hiện=Ý Thức Cụ Hiện
gấp tám lần vận tốc=Tốc Độ Thoái Hóa Gấp Tám Lần
Bát Văn Thì Lưu Thú=Thú Điều Khiển Thời Gian Tám Vằn
hoa la=Hoa La
âm thanh bắt chước=Bắt Chước Âm Thanh
Âu Khâu Thú=Khủng Long Ăn Cỏ
Âu đồi thú=Thú Âu Khâu
lợi nhiều hơn=Lợi Đa Gia
địa hắc thú=Thú Đất Đen
đất hắc thú=Thú Đất Đen
ba thái kê trứng=trứng Gà Ba Màu
tam thải trứng gà=trứng Gà Ba Màu
Thanh tơ tằm=Tằm Tơ Xanh
chế y nhà xưởng=Xưởng May
nhân viên cửa hàng=nhân viên bán hàng
xốp giòn nhi=Tô Nhi
Tổng trưởng Tam quan= Tổng trưởng Tam quan 
máy chụp hình=Máy Quay Phim chụp ảnh
luyện khí sư=Luyện Khí Sư
Tám nhãn ma kiệt=Ma Kết Tám Mắt
Phương Thiên Họa Kích=Phương Thiên Họa Kích
Lăng nốt hương=Lăng Hương
Đức Đức nhiều Nhĩ=Đức Đức Đa Nhĩ
Xảo Nhi=Xảo Nhi
Trinh Hoán=Trinh Hoán
Na Á=Na Á
Cùng nhĩ nạp=Tề Nhĩ Lạp
chạy mau vịt=Vịt Chạy Nhanh
nguyệt kế nhan=Nguyệt Phi Nhan
kiến thợ=Kiến Thợ
Diane=Đại An Ti
Đại An Ti Ti=Đại An Ti
sàn bán đấu giá=sân bán đấu giá
long kỵ sĩ=Kỵ Sĩ Rồng
Ấu lan=Ấu Lan
Lan Tila=Lan Đế
đấu giá hội=hội đấu giá
giác tỉnh giả=Giác Tỉnh Giả
sừng thú=Thú Một Sừng
Phi nhan=Phi Nhan
hải ma thú=ma thú biển
Màu trắng đen Linh thú=Linh thú màu trắng đen
thần xạ thủ tiểu đội=tiểu đội xạ thủ
cô nhi viện=Viện Mồ Côi
nhổ điểm=cao điểm
trạch thành=thành Trạch
thuần dưỡng điểm=Điểm thuần dưỡng
mạo hiểm giả=nhà mạo hiểm
Hải Thần=Hải Thần
Không quân binh sĩ=binh sĩ Không Quân
Ốc Đảo bốn vị trưởng lão=bốn vị trưởng lão Ốc Đảo
Ốc Đảo Đại trưởng lão=Đại trưởng lão Ốc Đảo
Ốc Đảo Nhị trưởng lão=Nhị trưởng lão Ốc Đảo
Ốc Đảo Tam trưởng lão=Tam trưởng lão Ốc Đảo
Ốc Đảo Tứ trưởng lão=Tứ trưởng lão Ốc Đảo
chúng ta thành chủ đại nhân=thành chủ đại nhân của chúng ta
Nhân thể Linh khí hóa thí nghiệm=Thí Nghiệm Linh Khí Cơ Thể Người
cao điểm=Khu Vực Trung Ương
Khu Vực Trung Ương hộ vệ=hộ vệ Trung Ương
Khu Vực Trung Ương cung điện=cung điện Khu Vực Trung Ương
chí hải=Chí Hải
vạn bái=Vạn Bái
diêu nhi=Diêu Nhi
tam thải gà=Gà Ba Màu
tam thải kê=Gà Ba Màu
Kim Mao Áp=Vịt Lông Vàng 
Mục Lương Mộc Phân Thân=Mộc Phân Thân Mục Lương
mộc Phân Thân=Mộc Phân Thân
Ny Cát Toa=Ny Cát Sa
phi hành phiếu=vé máy bay
Đầu tàu nghiên cứu=nghiên cứu đầu máy xe lửa
đèn lồng giáp trùng=Bọ Cánh Cứng Đèn Lồng
Nhân thể Linh khí kế hoạch=Thí Nghiệm Linh Khí Cơ Thể Người
hung thú tài liệu=tài liệu hung thú
linh khí cao cấp Sư=Linh khí sư Cao cấp
Tứ giác man ngưu=Trâu Bốn Sừng
đi hoang thương nhân=thương nhân hành hoang
Phong trưởng lão=trưởng lão Phong
tiệm trái cây=Quầy Trái Cây
Khen Viêm=Tán Viêm
sơ cấp trung đẳng tinh thạch hung thú=tinh thạch hung thú sơ cấp trung đẳng
sơ cấp thượng đẳng tinh thạch hung thú=tinh thạch hung thú sơ cấp thượng đẳng
kaidou=Khải Đa
hộ thành Linh thú=Linh thú hộ thành
Ách tại=Ách Vu
Lục Cách=Lục Cách
nhị trưởng lão=Nhị trưởng lão
huyễn ảnh che chắn=lá chắn ảo ảnh
Trưởng lão các=Nhà Chính
Belt=Bối Nhĩ Đặc
Vệ Ấu Lan=Vệ Ấu Lan
bình lưu ly chướng=bức tường lưu ly
Lỵ Lina=Lỵ Lỵ
Ederon=Ngải Đức Luân
chỉ giết=Trỉ Chu
Hắc Phát Yêu · Chỉ=Hắc Phát Yêu Tri Chu
Tri Chu=Trỉ Chu
dệt vải nhà xưởng=Xưởng Dệt Vải
nổ tung cây=Măng Cụt Bom
tiểu chiến trống=trống chiến
yêu cổ=trống cơm
Chiêm Mục=Mục Chiêm
Cái lộ na=Lộ Na
đầu trâu người thú=người thú đầu trâu
công xưởng=nhà xưởng
huyền vũ trống trận=Trống trận Huyền Vũ
Lý Nhị Cốt=Lý Nhị Cốt
lời băng=Ngôn Băng
Chí trưởng lão=trưởng lão Chí
sơ cấp linh khí sư=Linh khí sư Sơ cấp
sơ cấp Linh khí=linh khí sơ cấp
Già Lạc trưởng lão=trưởng lão Già Lạc
Linh khí dao động=dao động linh khí
Xe đạp cửa hàng=cửa hàng Xe Đạp
Lục Cam Ma=Đay Lục Cam
Vải Và Trang Phục cửa hàng=cửa hàng Vải Và Trang Phục
xưởng dệt vải=Xưởng Dệt Vải
Ari=A Lệ
trị liệu ‘Hư Quỷ Cảm Nhiễm’ bí dược=bí dược trị liệu ‘Hư Quỷ Cảm Nhiễm'
công xưởng người quản lý=Quản lý xưởng
thú huyết=máu thú
cường hóa cơ thể bí dược=bí dược cường hóa cơ thể
huyền vũ Vườn sinh thái=Vườn sinh thái Huyền Vũ
Thủy nguyên tố=nguyên tố nước
Tinh Thần Quả=quả Tinh Thần
Vườn sinh thái=Vườn Sinh Thái
hỏa xa=Xe Lửa
tinh thể che chắn=lưu ly che chắn
lưu ly che chắn=bức tường lưu ly
lời băng=Ngôn Băng
Trọng lực Điều Khiển=Điều Khiển Trọng Lực
Trọng lực chưởng khống=Khống Chế Trọng Lực
Trọng lực khống chế=Khống Chế Trọng Lực
linh khí nhà xưởng=Xưởng Chế Tạo Linh Khí
thợ sửa chữa phường=Xưởng Trang Trí
hành phạt giả=thẩm phán 
u linh đặc chủng ám sát đội=Đội Ám Sát U Linh Chiến Thuật
u linh bộ đội đặc chủng=Bộ Đội Đặc Chủng U Linh
U Linh Đặc Chủng Bộ Đội=Bộ Đội Đặc Chủng U Linh
Đồng Thanh Trùng=Trùng Truyền Âm
Cộng Minh Trùng=Trùng Cộng Hưởng
chữa thương canh=Canh Chữa Thương
đại thị trường=Siêu Thị Huyền Vũ
đồ gia dụng công xưởng=Xưởng Đồ Gia Dụng
đồ gốm công xưởng=Xưởng Đồ Gốm
Tạp Nhi Y=Tạp Nhi Y
Ca kịch viện=Viện Ca Kịch
nuôi thực tràng=Trại Chăn Nuôi
phòng ăn=nhà ăn
trở mặt=Biến Đổi Khuôn Mặt
Ny Cát Toa=Ni Cát Toa
Dị Biến Giả= Biến Dị Giả
bốn chiều giao diện thuộc tính=giao diện thuộc tính bốn chiều
Co dãn biến hình=Co Giãn Biến Dạng
Thực âm thú=Thú Thực Âm 
Gấp năm lần cực tốc=Chạy Nhanh Gấp 5 Lần
Cấm Thanh Lĩnh Vực=Lĩnh vực Im lặng
Tinh Thần lĩnh vực=Lĩnh Vực Tinh Thần
vườn trái cây=Vườn Trái Cây
thành Huyền Vũ chủ=thành chủ thành Huyền Vũ
Lợi Áo Ba Lư=Áo Lợi Ba
Áo Lợi Ti=Áo Lợi Tư
Cát Tư Dạ Nguyệt=Dạ Nguyệt Cát Tư
Lộ Pháp gia tộc=gia tộc Lộ Pháp
La Lan Na=Lan Na
người thú hài tử=đứa bé người thú
Đội Phòng Cháy Chữa Cháy=Đội Phòng Cháy Chữa Cháy
dập lửa tề=thuốc dập lửa
Giáp nhất đường phố=Đường Giáp Thứ Nhất
Đại trưởng lão=Đại trưởng lão
Tam trưởng lão=Tam trưởng lão
ma cà rồng thuộc hạ=thuộc hạ Ma Cà Rồng
trung cấp chấp sự=chấp sự trung cấp
cao cấp chấp sự=chấp sự cao cấp
dạ nguyệt gia tộc=gia tộc Dạ Nguyệt
ủng thành=Úng Thành
Huyền Vũ thành Ngoại thành=Ngoại Thành thành Huyền Vũ
Chu Tước Phiến=Quạt Chu Tước
tai lông tơ thỏ=Thỏ Tai Cụp Lông Nhung
tỏa Sáng Lấp Lánh=tỏa sáng
hung thú tinh thạch=tinh thạch hung thú
đuôi cáo=đuôi hồ ly
lúa mì rượu=rượu lúa mì
hấp huyết quỷ=Ma Cà Rồng
cây cao su=Cây Cao Su
Vưu Phỉ=Vưu Phi Nhi
nước mắt của Thiên sứ=Nước Mắt Thiên Sứ
Lưu Ly bình chướng=bức tường lưu ly
chu tước khôi giáp=Khôi Giáp Chu Tước
nhân viên công tác=nhân viên bán hàng / nhân viên phục vụ
quân công phường=Phường Công nghiệp Quân Sự
cường hóa bí dược=bí dược cường hóa
chữa thương bí dược=bí dược chữa thương
Thành Phòng đội trường=đội trưởng Thành Phòng Quân
trời sinh mị hoặc=Mị Hoặc Trời Sinh
Thiên môn lầu=Thiên Môn Lâu
băng ẩm điếm=Tiệm Đồ Uống Lạnh
Sơn Hải Quan=Sơn Hải Quan
hầu gia=hầu gia
linh hồn bước sóng=bước sóng linh hồn
thú nhân=người thú
bán thú nhân=nửa người thú
bán người thú=nửa người thú
Linh Hồn Chuyển Sinh=Linh Hồn Chuyển Sinh
Lôi Linh Thú=Kỳ Lân
Thú Vương điện=điện Thú Vương
hăc bào= áo choàng đen
Viêm Tượng hầu gia=hầu gia Viêm Tượng
Phong Thanh Lang hầu gia=hầu gia Phong Thanh Lang
Hồ Tiên hầu gia=hầu gia Hồ Tiên
Hoang Cổ Man Thú=Man Thú Hoang Cổ
Lôi Linh Thú đản=trứng Lôi Linh Thú
giác tỉnh Năng Lực Giả=Giác Tỉnh Giả
Lang Đầu thú nhân=thú nhân đầu sói
đầu sư tử thú nhân=thú nhân đầu sư tử
Ngân Hàng tư nhân=Ngân Hàng
Cà chua vị trà=Trà vị cà chua
giác tỉnh năng lực=năng lực giác tỉnh
Nguyệt Đàm bộ lạc=bộ lạc Nguyệt Đàm
tuần cảnh vệ=Tuần Cảnh Vệ
tiền trang=Ngân Hàng
phòng ngừa bạo lực phục=đồ bảo hộ
đào ly=ly sứ
băng uống tiệm=tiệm đồ uống lạnh
Huyền Vũ tiền=đồng Huyền Vũ
Tam nguyên Huyền Vũ tiền=ba đồng Huyền Vũ
Huyền Vũ ngân hàng=Ngân Hàng Huyền Vũ
độ cân nhắc=cân đòn
Nguyệt Chủ đại nhân=Nguyệt Chủ đại nhân
Lợn Tám Răng Nanh thịt=thịt Lợn Tám Răng Nanh
vật tư giá cả=giá cả vật tư
lưu ly Lục Lạc Chuông=chuông lục lạc lưu ly
cống hiến đơn=đơn cống hiến
nhóm đầu tiên cư dân=nhóm cư dân đầu tiên
Thành Chủ Phủ=Phủ Thành Chủ
Thành Huyền Vũ tiểu quảng trường=quảng trường nhỏ Thành Huyền Vũ
Ma Dương Sáu Sừng lông thú=lông Ma Dương Sáu Sừng
thiết kế đồ=bản thiết kế
sơ cấp bản thiết kế=bản thiết kế sơ cấp
cao cấp linh khí=linh khí cao cấp
trung cấp linh khí sư=Linh Khí sư Trung cấp
Trung cấp linh khí=linh khí trung cấp
cao cấp Linh Khí Sư=Linh Khí Sư cao cấp
Băng Minh Xà miếng vảy=vảy Băng Minh Xà
Thủy Tinh Ngư miếng vảy=vảy Thủy Tinh Ngư
Ưng Lửa lông vũ=lông vũ Ưng Lửa
hàn băng đặc tính=đặc tính hàn băng
linh khí xưởng=Xưởng Linh khí
thủ vệ đội=đội thủ vệ
bay quy tắc=Quy Định Bay Trên Không
Thư phòng cửa=cửa thư phòng
điểm cống hiến trị=điểm cống hiến
Ngoại thành khu=Khu vực Ngoại Thành
Ngoại thành=Ngoại Thành
Nội thành=Nội Thành
lưu ly ống hút=ống hút pha lê
mạch lộ=mạch lộ
nghi thức khải linh=nghi thức khải linh
'Huyền vũ hào' ưng lửa=Máy Bay Ưng Lửa/Máy Bay Ưng Lửa số hiệu Huyền Vũ
cmnd=chứng minh nhân dân
Huyền Vũ Hào=Máy Bay
Huyền Vũ Hà=sông Huyền Vũ
tạo giấy xưởng=Xưởng Giấy
Lưu Ly xe=Xe ngựa
xưởng khu vực=khu vực nhà xưởng
công xưởng khu vực=khu vực nhà xưởng
công xưởng khu=khu vực nhà xưởng
thành phẩm kho=kho chứa sản phẩm
tiền giấy xưởng=Xưởng In Tiền
Tiền Tệ xưởng=Xưởng In Tiền
nghiên cứu sở=Sở Nghiên Cứu
Sở Nghiên Cứu=Sở Nghiên Cứu
biến sắc thuốc màu=thuốc đổi màu
hồng sắc thuốc màu=thuốc nhuộm màu đỏ
kim sắc thuốc màu=thuốc nhuộm màu vàng

Mục Lương=Mục Lương
Minol=Mễ Nặc
Nguyệt Thấm Lam=Nguyệt Thấm Lan
thấm lam=Thấm Lan
Nguyệt Phi Nhan=Nguyệt Phi Nhan
Ly Nguyệt=Ly Nguyệt
Yufir=Vưu Phi Nhi
Yuffie=Vưu Phi Nhi
Elina=Ngải Lỵ Na
Dap=Đạt Phổ
Liding=Lợi Đinh
Huyết Hồ Tử=Huyết Hồ Tử
Mya=Mễ Á=Mễ Á
Sybelle kỳ=Hi Bối Kỳ
Ngôn Băng=Ngôn Băng
Waldo=Ngõa Nhĩ Đa
Nikisha=Ny Cát Sa
Mỹ Ny=Mỹ Ny
Tô Nhi=Tô Nhi
Thái Căn=Thái Căn
Khôi Giáp U Linh=Khôi Giáp U Linh
Trình Mâu=Trình Mâu
Y Lệ Y=Y Lệ Y 
Lao Mông=Lao Mông
Lý Nhị Cốt=Lý Nhị Cốt
Phi Thi=Phi Thi
Trỉ Chu=Trỉ Chu
Tóc đen yêu=Hắc Phát Yêu
A Mạn=A Mạn
Trình Mâu=Trình Mâu
Cao Thao=Cao Thao
Vệ Cảnh=Vệ Cảnh
Tán Viêm=Tán Viêm
Dụ Tử=Dụ Tử
Trình Tiếu=Trình Tiếu
Toa Đóa Na=Toa Đóa Na
Nhã Kỳ=Nhã Kỳ
Lý Tiểu Cốt=Lý Tiểu Cốt
Ngõa Nhĩ Cam=Ngõa Nhĩ Cam
Đạt Tư=Đạt Tư
Kema=Mã Khắc 
Shakov=Hạ Khoa Phu
Charlotte=Hạ Lạc
Shanane=Hạ Nạp Ân
Charot=Hạ La Thái
Landy=Lan Đế
Bách Biến Ma Nữ=Bách Biến Ma Nữ
Cốt Thương=Cốt Thương
Khỏa Thi Bố=Khỏa Thi Bố
Hắc Phát Yêu=Hắc Phát Yêu
Nham Giáp Quy=Rùa Đen
Ngũ Thải Tích Dịch=Kỳ Nhông Năm Màu
Thiên Sứ Chi Dực=Đôi Cánh Thiên Sứ
Thủy Tinh Ngư=Thủy Tinh Ngư
Phát Quang Trùng=Đom Đóm
Hồng Quỷ Tri Chu=Nhện Qủy Đỏ
Thiểm Diệu Giáp Trùng=Bọ Cánh Cứng Lấp Lánh
Đăng Lung Giáp Trùng=Bọ Cánh Cứng Đèn Lồng
Tam Gi ác Dương=Cừu Ba Sừng
Tam Giác Dương=Cừu Ba Sừng
Lục Giác Ma Dương=Ma Dương Sáu Sừng
Băng Minh Xà=Băng Minh Xà
Bát Giác Lão Nha Thú=Lợn Tám Răng Nanh
Tinh Thần Trà Thụ=Trà Thụ Tinh Thần
tinh thần cây trà=Trà Thụ Tinh Thần
tinh thần trà diệp=lá trà tinh thần
tinh thần trà=trà tinh thần
Cửu Tiết Ma Trùng=Ma Trùng Chín Đốt
Nguyệt Lang=Sói Mặt Trăng
Thiên Ong=Ong Trời
Thiên Vương Ong=Ong Chúa
Mê Vụ Hoa=Hoa Sương Mê
Thiên Cức Hoa=Hoa Ngàn Gai
Lục Túc Ma Thiềm=Thiềm Thừ Sáu Chân
Thất Thải Thiền=Ve Bảy Màu
thú lôi linh=Kỳ Lân
Muỗi Dạ Ma=Muỗi Dạ Ma
Lưu Ly Thú=Sóc Lưu Ly
Hỏa Vũ Ưng=Ưng Lửa
Khoái Bào Áp=Vịt Chạy Nhanh
Hỏa Gi áp Thằn Lằn=Kỳ Nhông Lửa
Điều Khiển Trọng Lực Địa Nham Gấp Hai Mươi Lần=Điều Khiển Trọng Lực Địa Nham Gấp Hai Mươi Lần
Lân Giáp Tàng Hình=Lân Giáp Tàng Hình
Nước Mắt Thiên Sứ=Nước Mắt Thiên Sứ
Điều Khiển Nước=Điều Khiển Nước
Phát Sáng Lấp Lánh=Phát Sáng Lấp Lánh
Thao Túng Thiên Ti=Thao Túng Thiên Ti
Điều Khiển Nguyên Tố Ánh Sáng=Điều Khiển Nguyên Tố Ánh Sáng
Sáng Lấp Lánh=Sáng Lấp Lánh
Phản Xạ Xông Tới=Phản Xạ Xông Tới
Điều Khiển Hàn Băng=Điều Khiển Hàn Băng
Lĩnh Vực Tinh Thần=Lĩnh Vực Tinh Thần
Trọng Lực lĩnh vực=Lĩnh Vực Trọng Lực
Biến Đổi Dưới Trăng=Biến Đổi Dưới Trăng
Khế Ước Ong Chúa=Khế Ước Ong Chúa
Ong Chúa Khế Ước=Khế Ước Ong Chúa
Phấn Hoa Mê Man=Phấn Hoa Mê Man
Ngàn Gai Đâm=Ngàn Gai Đâm
Điều Khiển Nguyên Tố Lôi=Điều Khiển Nguyên Tố Lôi
Điều Khiển Tinh Thể=Điều Khiển Tinh Thể
Điều Khiển Nguyên Tố Lửa=Điều Khiển Nguyên Tố Lửa
Tiểu Huyền Vũ=Tiểu Huyền Vũ
Tiểu Thải=Tiểu Thải
Tiểu Hồng=Tiểu Hồng
Tiểu Thiểm=Tiểu Thiểm
Tiểu Tử=Tiểu Tử
Tiểu Bạch=Tiểu Bạch
Tiểu Vũ=Tiểu Vũ


Điểm Liên Lạc=Điểm Liên Lạc
liên Lạc điểm=Điểm Liên Lạc
Phòng Quân thành=Thành Phòng Quân
quân bảo vệ thành=Thành Phòng Quân
Thành Phòng Quân=Thành Phòng Quân
Vệ Tuần Tra=Vệ Tuần Tra
Tuần Tra vệ=Vệ Tuần Tra
Phi Điểu Tuần Vệ=Tuần Vệ Phi Điểu
Phố Buôn Bán=Phố Buôn Bán
Thương Nghiệp khu=Phố Buôn Bán
Mỹ Thực Lâu=Mỹ Thực Lâu
Quan Hải Sơn=Quan Hải Sơn
Úng Thành=Úng Thành
Phủ Thành Chủ=Phủ Thành Chủ
Thông Quan Văn Điệp=Văn Điệp Thông Quan
Hư Quỷ Cảm Nhiễm=Hư Quỷ Cảm Nhiễm
Thiên Môn Lâu=Thiên Môn Lâu
Huyền Không Các=Huyền Không Các
Tam Tinh Lâu=Tam Tinh Lâu
Tam Hải Quan=Tam Hải Quan
Đường Giáp Thứ Nhất=Đường Giáp Thứ Nhất
đường Giáp Thứ Hai=đường Giáp Thứ Hai
đường Giáp Thứ Ba=đường Giáp Thứ Ba
Hoa Ngàn Gai=Hoa Ngàn Gai
Trân Bảo Lâu=Trân Bảo Lâu
Mỹ Vị Hồng Thự Điếm=Tiệm Mỹ Thực Khoai Lang
Khu Vực Trung Ương=Khu Vực Trung Ương
Thức Tỉnh Giả=Thức Tỉnh Giả
Cường Hóa Giả=Cường Hóa Giả
Biến Dị Giả= Biến Dị Giả
cống hiến điểm=điểm cống hiến
cảnh sát trưởng=cảnh sát trưởng
thương nhân hành hoang=thương nhân hành hoang
Bạch Lưu Ly=Bạch Lưu Ly
đường đao=Kiếm Nhật
phiếu điểm cống hiến=phiếu điểm cống hiến
Man Thú Hoang Cổ=Man Thú Hoang Cổ
u linh áo choàng lá chắn=Phi Phong Thuẫn U Linh
U Linh Phi Phong Thuẫn=Phi Phong Thuẫn U Linh
U Linh Khôi Giáp=Khôi Giáp U Linh
Khôi Giáp Chu Tước=Khôi Giáp Chu Tước
Khu Vực Trung Ương tám tầng=Khu Vực Trung Ương tầng tám
Khu Vực Trung Ương bảy tầng=Khu Vực Trung Ương tầng bảy
Khu Vực Trung Ương sáu tầng=Khu Vực Trung Ương tầng sáu
cải tiến bên trong=đang được cải tiến
Thích xứng trung=Đang điều chỉnh
thay đổi trung+đang được cải tiến
Thích phối bên trong=Đang điều chỉnh
Truyền thừa hoàn tất=Hoàn tất truyền thừa
thủy màu lam đôi mắt đẹp=đôi mắt màu xanh nước biển
tam tinh lầu=Tam Tinh Lâu
Tiểu nhân bội=Tiểu Bội
Mặc liên=Mặc Liên
xét vé=soát vé
cắt băng nghi thức=nghi thức cắt băng
phú có thể trân châu=Phú Năng Trân Châu
màn sân khấu=màn chiếu phim
video máy chiếu phim=Máy Chiếu Phim
quỷ ảnh con nhện=Nhện Quỷ Ảnh
Thành Huyền Vũ Ảnh Nghiệp=hãng phim thành Huyền Vũ
Băng uống cửa hàng=Tiệm Đồ Uống Lạnh
tuần tra Sứ=Tuần Sát Sứ
quân doanh=Quân Doanh
Ngục Giam=Ngục Giam
Làm gấm=Tố Cẩm
Bạch Ngọc=Bạch Ngọc
Phi hành quải trượng=gậy chống phi hành
Giao linh na=Phó Linh Na
Khải Binns=Khải Tân Tư
mai đặc biệt=Mai Đặc
Nguyệt Thấm xanh=Nguyệt Thấm Lan
cát đất=Cát Đất
Schilling=Hi Lâm
hi dừng=Hi Tê
Tám văn lúc lưu thú=Bát Văn Thì Lưu Thú 
Ma Pháp Sư trường học=Học Viện Ma Pháp
Đen tù thành=thành Hắc Tù
đen dậu thành=thành Hắc Tù
Tây Hoa vương quốc=vương quốc Tây Hoa
rạp chiếu phim=Rạp Chiếu Phim
Lan Đế=Lan Đế
Lăng hương=Lăng Hương
Nhập mộng=Nhập Mộng
Ăn mộng thú=Thú Ăn Giấc Mơ
sói mặt trăng xe thú=xe thú Sói Mặt Trăng 
tiểu ừm=Tiểu Nặc
khảo thí linh tính=kiểm tra linh tính
Bội Cát Na=Bội Cát Na 
tỷ tỷ đẹp đẽ=Tỷ tỷ xinh đẹp
Thành Trong Thành=Tiểu Thành
tiểu quả=Tiểu Quả
mạch dựng=Mạch Cái
mạch nắp=Mạch Cái
Maggy=Mã Cát
Ma lực luồng khí xoáy=vòng xoáy ma lực
mây hân=Vân Hân
trình cười=Trình Tiếu
Y lệ theo=Y Lệ Y
trường học=Trường Học
nhà máy số 1=Nhà Máy Số Một
nhân bản thú=Thú Nhân Bản
u Linh Doanh giáp=Khôi Giáp U Linh
vũ cách=Vũ Cách
camera=Máy Quay Phim
Máy Quay Phim=Máy Quay Phim
học viện pháp thuật=Học Viện Ma Pháp
tạp tốt=Tạp Giai
dụ đang thương hội=hiệu buôn Dụ Chính 
đen Ma Pháp Sư=Hắc Ma Pháp Sư
Thanh vụ=Thanh Vụ
Phòng Đấu Giá=Phòng Đấu Giá
Rạp Chiếu Phim=Rạp Chiếu Phim
sinh mệnh cây=Trà Thụ Sinh Mệnh 
quang minh hệ ma pháp=ma pháp hệ quang minh 
không gian hệ=hệ không gian
ám hệ Ma Pháp Sư=Ma Pháp Sư hệ ám 
ma pháp nguyên tố=nguyên tố ma pháp
Hàn thủy giáp trong=Giáp Trong Hàn Thủy
Bắc Hải đại thành=thành Bắc Hải
Bắc Hải thành=thành Bắc Hải
sơn thành=thành Sơn
chim bay thành=thành Phi Điểu
trăng đêm thành=thành Dạ Nguyệt
Phi Điểu thành=thành Phi Điểu
áo ba thành=thành Áo Ba
băng thành=thành Băng
Tấn Nguyên thành=thành Tấn Nguyên
áo ước thành=thành Áo Ước
sa thành=thành Sa
Bình Lang thành=thành Bình Lang
Vạn Khô thành=thành Vạn Khô
Buck thành=thành Ba Khắc
buck đại thành=thành Ba Khắc
Thánh Dương thành=thành Thánh Dương
Huyền Vũ thành=thành Huyền Vũ
Thập Lâu thành=thành Thập Lâu
Dạ Nguyệt thành=thành Dạ Nguyệt
Vạn Yêu thành=thành Vạn Yêu
Tương Lai thành=thành Tương Lai
Bách lý thành=thành Bách Lý
Giáp thành=thành Giáp
Nhất Hải thành=thành Nhất Hải
Phượng thành=thành Phượng
phi long cốc=Cốc Phi Long