học đồ cấp=cấp Học Đồ
hồng ảnh=Hồng Ảnh
Ảo thuật lưu phái=pháp thuật hệ
Ma văn viện nghiên cứu=viện nghiên cứu Ma Văn
ma văn phụ thể trung tâm=trung tâm Phụ thể Ma Văn
thể nội=bên trong cơ thể
ma văn bút=bút Ma Văn
hư không kẻ cướp đoạt=Kẻ Cướp Đoạt Hư Không
trác việt thiên phú=thiên phú Trác Việt
ma hóa mắt ưng=Mắt Ưng Ma Hóa
khôn kim nham=Khôn Kim Nham
ta dựa vào=mẹ nó
thần bí hoa văn=hoa văn thần bí
thiên phú cấp bậc=cấp bậc thiên phú
hư không cướp đoạt=Cướp Đoạt Hư Không
Hư không hành tẩu=Bước Đi Trong Hư Không
hư không năng lượng=năng lượng hư không
sinh tồn nhu cầu=nhu cầu sinh tồn
kẻ cướp đoạt thể chất=Kẻ Cướp Đoạt Thể Chất
Sparta các chiến sĩ=các chiến sĩ Sparta
truyền tấn thủy tinh=thủy tinh truyền tấn
hướng về=về hướng
Lãnh địa xung quanh=xung quanh lãnh địa
cự ma=Cự Ma
nhạy cảm khứu giác=khứu giác nhạy bén
tự lành năng lực=năng lực hồi phục
tham dự=tham gia
phi thường=cực kỳ
sài lang nhân=Sài Lang Nhân
thức tỉnh môi giới=môi giới thức tỉnh
phi tác=Phi Tác
Amazon nữ chiến sĩ=nữ chiến sĩ Amazon
[ trước mặt số lượng=[ Số lượng hiện tại
hiện giá=giá hiện tại
hắc diệu thạch=đá Hắc Diệu
đối lập mà đứng=đứng đối diện nhau
nói rằng=nói
Amazon chiến kỹ=Chiến kỹ Amazon
du xạ=Du Xạ
anh hùng đơn vị=đơn vị Anh Hùng
vật liệu đặc biệt của kiến trúc=vật liệu kiến trúc đặc biệt
phong bạo xạ kích=Phong Bạo Xạ Kích
bản năng chiến đấu=Bản Năng Chiến Đấu
trang bị giới thiệu=giới thiệu trang bị
ma văn viện nghiên cứu=viện nghiên cứu Ma Văn
chế tạo kỹ thuật=kỹ thuật chế tạo
lôi tinh linh chi tâm=Trái tim của Lôi Tinh Linh
Amazon bộ lạc=Bộ Lạc Amazon
sâm lâm cự ma=Cự Ma Sâm Lâm
chủng tộc đẳng cấp=cấp độ chủng tộc
lãnh chúa quyền hành=quyền hành lãnh chúa
lĩnh đội trưởng lão=trưởng lão dẫn đội
bất động thanh sắc=mặt không đổi sắc
một mặt im lặng=không biết nói gì
nhất lưu thế lực=thế lực nhất lưu
nhị lưu thế lực=thế lực nhị lưu
tam lưu thế lực=thế lực tam lưu
nhất lưu tông phái=tông phái nhất lưu
nhị lưu tông phái=tông phái nhị lưu
tam lưu tông phái=tông phái tam lưu
nồng đậm sát cơ=sát cơ nồng đậm
nói ra.=nói.
nhất lưu gia tộc=gia tộc nhất lưu
nhị lưu gia tộc=gia tộc nhị lưu
tam lưu gia tộc=gia tộc tam lưu
nguyên lai=thì ra
Đó là tự nhiên=đương nhiên rồi
Có ý tứ gì=ngươi nói vậy là sao
Ma Văn viện nghiên cứu=viện nghiên cứu Ma Văn
phẩm cấp trước mắt=phẩm cấp hiện tại
cấp độ trước mắt=cấp độ hiện tại
Ma Văn trung tâm viện nghiên cứu=Trung tâm nghiên cứu Ma Văn
phảng phất thấy được=giống như thấy được
[ phó chức nghiệp=[ Chức nghiệp phụ
phu phụ=vợ chồng
Tự nhiên là=đương nhiên là
diệt hắn cửu tộc=diệt cửu tộc của hắn
trên người bảo vật=bảo vật trên người
kiện linh khí=món linh khí
tu luyện sau=sau khi tu luyện
nhục thân phòng ngự=sức phòng ngự của nhục thân
không nên có thể=không thể
Tuy nhiên những=tuy những
là người nào cũng=ai cũng
cam đoan=đảm bảo
Căn cứ sư tôn thuyết pháp=theo như sư tôn nói
thứ này có bối cảnh người=người có bối cảnh thế này
thì có cái gì=còn có gì
sư huynh đệ hai=hai sư huynh đệ
ngươi vừa mới=vừa rồi ngươi
không gian truyền tống trận phù=trận phù truyền tống không gian
toàn lực xuất thủ=ra tay toàn lực
ngay tại một gian trong phòng=đang ở trong một gian phòng
Thiên Vũ thành=thành Thiên Vũ
Phong Vân trấn=trấn Phong Vân
Lạc Vũ thành=thành Lạc Vũ
Muốn là hắn=nếu hắn
một cỗ=một luồng
cuồng bạo khí tức=khí tức cuồng bạo
hướng về xung quanh khuếch tán mà đi=lan rộng ra xung quanh người hắn
hướng về xung quanh khuếch tán=lan rộng ra xung quanh người hắn
hướng xung quanh khuếch tán=lan rộng ra xung quanh người hắn
Chuyện khi nào=chuyện xảy ra khi nào
trên thân=trên người
đại điện bên ngoài=ngoài đại điện
một gian trong phòng=trong một gian phòng
ngay tại một=đang ở trong một
trên người bảo giáp=bảo giáp trên người
phát ra một tiếng thốt lên=thốt lên một tiếng
sao có thể như vậy được?=sao lại như vậy?
Hồng di=Hồng ma ma
không thành.=hay sao?
không gian trận pháp=trận pháp không gian
một chút sao=một chút không
cự tuyệt=từ chối
theo sau lưng=từ sau lưng
Băng lãnh âm thanh=một giọng nói lạnh lẽo
thẳng đâm tới=đâm thẳng về phía
liền muốn đâm=sắp đâm
thường nhân=người thường
thực lực thấp người=người có thực lực thấp
bốn phía=xung quanh
võ đấu trường=Võ Đấu Trường
tại chiến đấu=đang chiến đấu
Ngươi cái phế vật=ngươi là đồ phế vật
Thanh âm=âm thanh
Không nghĩ tới=không ngờ
dạng này nữ tử=nữ tử như vậy
theo địa phương khác=từ nơi khác
vì cái gì=vì sao
thành danh tuyệt kỹ=tuyệt kỹ thành danh
Không nghĩ tới a=thật không ngờ
gia hỏa này ý nghĩ=suy nghĩ của gia hỏa này
còn có thể không biết=sao có thể không biết
không phải vậy=nếu không thì
biến mất ngay tại chỗ=đột nhiên biến mất
phiền phức vô cùng=vô cùng phiến phức
Cái này thì xong rồi?=như vậy là xong rồi à?
trở về sau đó=sau khi trở về
về sau sự tình xảy ra=chuyện xảy ra sau đó
cuồng bạo trạng thái=trạng thái cuồng bạo
cao tầng chiến lực=chiến lực cao tầng
muốn là đụng phải=nếu như gặp phải
đều không nhất định=cũng chưa chắc
ta gần nhất=gần đây ta
khả năng cần=có thể cần
ngươi vì sao=tại sao ngươi
bên người=bên cạnh
chính mình phòng nhỏ=phòng nhỏ của mình
cặp mắt=đôi mắt
Hoàn Vũ cửa hàng=cửa hàng Hoàn Vũ
cường hãn thực lực=thực lực cường hãn
trong đầu tin tức=tin tức trong đầu
liền biết=đã biết
cụ thể cảnh giới=cảnh giới cụ thể
dạng này liền=như vậy
công năng=chức năng
Trận Đạo Chân Giải cơ sở thiên=Trận Đạo Chân Giải bản cơ sở
Ngươi nói sao?=Ngươi nói cái gì?
Đúng nha=Đúng vậy
tận mắt=chính mắt
cái khác=khác
báo thù cơ hội=cơ hội báo thù
tiểu lâu=nhà nghỉ
tá túc=ở lại
nhất giai=cấp 1
nhị giai=cấp 2
luyện kiếm thiên phú=thiên phú luyện kiếm
cửu giai=cấp 9
Vô danh phong=núi Vô Danh
nhà bên trong=trong nhà
huyền huyễn thế giới=thế giới huyền huyễn
xuyên việt nhân sĩ=người xuyên việt
nhân sinh đỉnh phong=đỉnh phong của nhân sinh
cái thế giới=thế giới
nguy hiểm vô cùng=vô cùng nguy hiểm
cửa lớn không ra=không bước chân ra khỏi cửa
có liên quan kỹ năng=kỹ năng có liên quan
ngoại môn trưởng lão=trưởng lão ngoại môn
nhắc nhở âm thanh=âm thanh nhắc nhở
hắc long lệnh kỳ=Hắc Long Lệnh Kỳ
bạch long lệnh sứ=Bạch Long Lệnh Sứ
khác bạch long lệnh sứ=Bạch Long Lệnh Sứ còn lại
Long hiểu rõ=Long Minh Bạch
long lệnh sứ=Long Lệnh Sứ
vạn thông hào=Vạn Thông Hào
chấn động vô cùng=vô cùng chấn động
Hắc Long võ mạch=Hắc Long Võ Mạch
 Long Minh minh chủ= minh chủ Long Minh
Diệp Chân Hắc Long Võ Mạch=Hắc Long Võ Mạch của Diệp Chân
Diệp Chân Huyền Hỏa Toản=Huyền Hỏa Toản của Diệp Chân
kinh người ba động=ba động kinh người
từng đạo từng đạo=từng đạo
hải lượng=một lượng lớn
truyền thuyết chi địa=vùng đất truyền thuyết
màu băng lam kiếm quang=kiếm quang màu băng lam
lục sắc sinh cơ lực lượng=lực lượng sinh cơ lục sắc
sinh cơ lực lượng=lực lượng sinh cơ
linh hồn lực lượng=lực lượng linh hồn
chân chính ý nghĩa=ý nghĩa chân chính
Oanh!=Đùng!
chí cao chân lý=chân lý vô thượng
sáng thế chi lực=lực lượng Sáng Thế
hắn vị trí=vị trí của hắn
chúc mừng ngươi,=chúc mừng ngài đã
chí cao pháp tắc=pháp tắc vô thượng
đẳng cấp tăng lên=cấp độ tăng lên
trước mắt đẳng cấp=cấp độ hiện tại
max trị số=tối đa
bản nguyên thế giới=Thế Giới Bản Nguyên
nhi tử=con trai
chưởng khống=khống chế
Quen thuộc tiếng nhắc nhở=âm thanh nhắc nhở quen thuộc
cải biến=thay đổi
tựa hồ có=giống như có
chưởng quản=quản lý
đại não=trong đầu
một mảnh oanh minh=đột nhiên nổ tung
đản sinh=sinh ra này
Ta nói qua=Ta đã nói
ai cũng trốn không thoát=không ai có thể trốn thoát
hết thảy=tất cả
đội ngũ bên trong=trong đội ngũ
sắc mặt=vẻ mặt
mãnh liệt tiến công=tấn công mãnh liệt
trong nháy mắt sụp đổ=sụp đổ trong nháy mắt
cỗ vô hình ba động=luồng ba động vô hình
chỗ đến=những nơi nó đi qua
thảm liệt vô cùng=vô cùng thảm liệt
nhịn không được=không nhịn được
ngập trời uy thế=uy thế ngập trời
Cái này sao có thể=sao lại như vậy
như thế kinh khủng=kinh khủng như thế
Không có khả năng=không thể nào
Ngươi làm sao=sao ngươi
Hắn làm sao=sao hắn
Nàng làm sao=sao nàng
Các ngươi làm sao=sao các ngươi
Hắn rõ ràng=rõ ràng hắn
Vì cái gì=vì sao
cảm tạ=cảm ơn
tạ ơn=cảm ơn
từ tốn nói=chậm rãi nói
lời vừa nói ra=vừa nói
Đối với ta làm cái gì=ngươi đã làm gì ta?
nộ hống=hét lớn lên
quỷ dị năng lực=năng lực quỷ dị
Tiếng nói vừa ra=hắn vừa nói hết câu
Thì liền xem như=cho dù là
cùng hắn nói nhảm=nói nhảm với hắn
nhục thể cường độ=cường độ nhục thể
Một quyền chi uy=uy lực một quyền
sinh mệnh khí tức=khí tức sinh mệnh
kỳ thật=thật ra
nằm thắng nhân sinh hệ thống=hệ thống Nằm Thắng Nhân Sinh
đồ đệ tu vi=tu vi của đồ đệ
kí chủ tu vi=tu vi của ký chủ
tương ứng tăng lên=tăng lên tương ứng
hưng phấn nụ cười=nụ cười hưng phấn
SSS cấp=cấp SSS
SS cấp=cấp SS
S cấp=cấp S
tu luyện thiên phú=thiên phú tu luyện
tu luyện đẳng cấp=cấp độ tu luyện
chiêu thu=thu nhận
tương đối tốt=sẽ tốt hơn
thì liền=ngay cả
tông chủ tu vi=tu vi của tông chủ
bất quá mới=chỉ mới là
thích hợp đồ đệ=đồ đệ thích hợp
làm gì dùng=làm cái gì
chung quanh=xung quanh
Muốn đến nơi này=nghĩ đến đây
tạp dịch đệ tử=đệ tử tạp dịch
ngoại môn đệ tử=đệ tử ngoại môn
nội môn đệ tử=đệ tử nội môn
chân truyền đệ tử=đệ tử chân truyền
tìm kiếm phạm vi=phạm vi tìm kiếm
kí chủ tự mình=kí chủ tự
tin tức mặt bảng=bảng thông tin
Thối thể=Thối Thể
Du Lâm thành=thành Du Lâm
liền gặp được=đã gặp được
việc lớn không tốt=xảy ra chuyện lớn rồi
biến đến=trở nên
thật tốt tu luyện=tu luyện thật tốt
ở một bên=ở bên cạnh
kí chủ xin=xin kí chủ
ở nơi nào=ở đâu
ta cái này liền=ta sẽ
kiên định lên=trở nên kiên định
Hiện tại mình=bây giờ mình
Ngươi tuy nhiên=tuy ngươi đã
tiểu môn phái=môn phái nhỏ
đại môn phái=môn phái lớn
chính đạo môn phái=môn phái chính đạo
Bất quá,=nhưng mà
hồi đáp=trả lời
Bất quá=nhưng
Đến mức=còn về
tàn khuyết=mảnh vỡ
ta làm sao=sao ta lại
Hắn lần trước=lần trước hắn
Chuyên gia cấp=cấp Chuyên Gia
Ngươi lần trước=lần trước ngươi
Ta lần trước=lần trước ta
Nàng lần trước=lần trước nàng
kiệt xuất tử đệ=tử đệ kiệt xuất
học đồ cấp rèn đúc sư=thợ rèn cấp Học Đồ
cấp Đại Sư rèn đúc sư=thợ rèn cấp Đại Sư
vô danh phong=núi Vô Danh
đây là ý gì=ngươi nói vậy là sao
có chút trợn tròn mắt=hơi trợn mắt lên
tu luyện giả=người tu luyện
thật tốt nghe=nghe cho kỹ
bất luận kẻ nào=bất cứ ai
tông phái nhiệm vụ=nhiệm vụ tông phái
địch nhân=kẻ địch
cứ như vậy nhiều=chỉ có như vậy thôi
dạng này người=người như vậy
lớn nhất bản sự=bãn lĩnh lớn nhất
muốn nhớ kỹ=phải nhớ kỹ
bất quá=nhưng mà
tu luyện tốc độ=tốc độ tu luyện
nhanh vô cùng=vô cùng nhanh
ngươi về sau=sau này ngươi
nàng về sau=sau này nàng
chàng về sau=sau này chàng
hắn về sau=sau này hắn
tuy nhiên không biết=tuy hắn không biết
cụ thể phẩm cấp=phẩm cấp cụ thể
chính mình tu luyện công pháp=công pháp mình đang tu luyện
không biết tốt gấp=tốt hơn không biết
tối thiểu cũng muốn=ít nhất cũng phải
tối thiểu=ít nhất
có thể làm đến=có thể làm được
Đa tạ=cảm ơn
Tuy nhiên chính hắn=tuy bản thân hắn
khủng bố năng lượng=năng lượng khủng bố
trong thân thể ẩn chứa=ẩn chứa trong thân thể
Vương Đằng thủ đồ=Đại đệ tử của Vương Đằng
tiến giai lễ bao=lễ bao lên cấp
thế nhưng là=chính là
liền muốn rơi lệ=đã muốn khóc
muốn không phải=nếu không phải
như thế nhanh=nhanh như thế
đều không là=cũng không phải là
Thẳng đến=mãi cho đến khi
làm sao sẽ=sao lại
vẫn là một tên=còn là một
hắn trước kia=trước đó hắn
trân quý đan dược=đan dược trân quý
cảm động vô cùng=vô cùng cảm động
chính mình một ngày=một ngày mình
muốn tu luyện=phải tu luyện
Về sau=sau này
Nghĩ đến thì làm=nghĩ là làm
liền bắt đầu=sau đó bắt đầu
vừa mới lấy được=vừa lấy được
phòng ngự trận pháp=trận pháp phòng ngự
Ngươi có phải=có phải ngươi
Ta nhìn ngươi=ta thấy ngươi
Đang khi nói chuyện=trong khi bọn hắn đang nói chuyện
trung niên nam tử=nam tử trung niên
cao tầng chiến lực=chiến lực cao tầng
cảm tạ=cảm ơn
Man Hoang sơn mạch=sơn mạch Man Hoang
chờ mấy vị=và mấy
tại giữa không trung=ở giữa không trung
dưới đáy đệ tử=đệ tử phía dưới
dưới đáy đám người=đám người phía dưới
tinh anh đệ tử=đệ tử tinh anh
mấy người sắc mặt=vẻ mặt mấy người
bọn người=mấy người
Nguyên lai=thì ra
tà đạo tổ chức=tổ chức tà đạo
không có việc gì=không có gì
còn mời nén=xin ngài nén
Sưu sưu=vù vù
Nguyên lai là=thì ra là
tà đạo tông môn=tông môn tà đạo
Kỳ thật,=thật ra
mấy năm này bên trong=trong mấy năm này
phát sinh=xảy ra
đại sự gì=chuyện lớn gì đó
nhưng mà hẳn=nhưng mà chắc là
cái gì chuyện gấp gáp=chuyện gấp gì đâu
ta nhìn=ta thấy
nội môn trưởng lão=trưởng lão nội môn
muốn là =nếu như 
muốn làm=phải làm
tin tức bảng=bảng thông tin
giả lập tin tức bảng=bảng thông tin giả lập
Sparta trại huấn luyện=Trại huấn luyện Sparta
Siêu phàm=Siêu Phàm
cấp bậc kiến trúc=kiến trúc cấp bậc
đẳng cấp=cấp độ
Một giai=Cấp 1
Nhị giai=Cấp 2
Tam giai=Cấp 3
Tứ giai=Cấp 4
Ngũ giai=Cấp 5
Lục giai=Cấp 6
Thất giai=Cấp 7
Bát giai=Cấp 8
Cửu giai=Cấp 9
Thập giai=Cấp 10
một giai=cấp 1
nhị giai=cấp 2
tam giai=cấp 3
tứ giai=cấp 4
ngũ giai=cấp 5
lục giai=cấp 6
thất giai=cấp 7
bát giai=cấp 8
cửu giai=cấp 9
thập giai=cấp 10
công năng=chức năng
đẳng cấp=cấp độ
thần cấp=cấp Thần
vương cấp=cấp Vương
đặc thù=đặc biệt
cung cung kính kính=cung kính
lĩnh dân=lãnh dân
cơ sở nghề nghiệp=nghề nghiệp cơ sở
lĩnh dân=lãnh dân
có hay không bắt đầu huấn luyện=có bắt đầu huấn luyện hay không
liền sẽ=đã sẽ
ánh mắt mong chờ bên trong=trong ánh mắt mong chờ
kiến trúc bản vẽ=bản vẽ kiến trúc
hướng về hành lễ=hành lễ với
Sparta chi nộ=cơn giận giữ của Sparta
ở chiến đấu thời điểm=trong lúc chiến đấu
thánh vực=Thánh Vực
tự đáy lòng cảm thán=cảm thán từ đáy lòng
Du Dương thành=thành Du Dương
địa rộng nhiều người=đất rộng người đông
Sự kiện này=chuyện này
Ngọc Lâm quận=quận Ngọc Lâm
một điểm dấu vết=một chút dấu vết
tựa như là=giống như là
hư không tiêu thất=đột nhiên biến mất
nguyên lai là=thì ra là
Chung quanh=xung quanh
tìm tòi phạm vi=phạm vi tìm kiếm
bạn tốt danh sách=danh sách bạn bè
giao dịch nền tảng=nền tảng giao dịch
không nghĩ tới=không ngờ lại
đụng tới=gặp phải
Hỗn Độn đại lục=đại lục Hỗn Độn
đánh dấu=điểm danh
hoàng kim tiềm lực=tiềm lực Hoàng Kim
hắc thiết tiềm lực=tiềm lực Hắc Thiết
Sparta dũng sĩ=dũng sĩ Sparta
hưng phấn dị thường=cực kỳ hưng phấn
liền truyền đến=đã truyền ra
quái vật số lượng=số lượng quái vật
nhiều vô cùng=cực kỳ nhiều
thu thập người=người thu thập
Hỗn Độn thương thành=Thương Thành Hỗn Độn
trữ vật túi=túi trữ vật
không có cự tuyệt=không từ chối
Đúng vậy a,=Đúng vậy,
Hảo lợi hại a=thật là lợi hại
Thanh Lâm quận thành=quận thành Thanh Lâm
thiên tài đệ tử=đệ tử thiên tài
chân mày cau lại=cau mày
đình chỉ tu luyện=ngừng tu luyện
Hảo huynh đệ=Huynh đệ tốt
cái kia chờ ta=vậy thì chờ ta
truyền tin phù=Truyền Tin phù
Thanh Lâm quận=quận Thanh Lâm
trong đầu âm thanh=âm thanh trong đầu
phổ thông kiến trúc=kiến trúc phổ thông
kiến trúc đặc biệt=kiến trúc đặc biệt
thần cấp đơn vị=đơn vị cấp Thần
thánh cấp đơn vị=đơn vị cấp Thánh
vương cấp đơn vị=đơn vị cấp Vương
danh sách bên trong=trong danh sách
thiên phú đệ tử=đệ tử thiên phú
Kiểm trắc đến=kiểm tra thấy
Ta dựa vào=Mẹ nó
đoán chừng=có lẽ
Thiên Lĩnh quận=quận Thiên Lĩnh
Ngọa tào=mẹ nó
kim ti hổ=Kim Ti Hổ
ánh mắt bên trong=trong ánh mắt
skill=kỹ năng
bản sách=quyển sách
Hiện giai đoạn=giai đoạn hiện tại
truyền kỳ kiến trục=kiến trúc Truyền Kỳ
kim quan ưng chi đồng=mắt của Kim Quan Ưng
đáp ứng=đồng ý
học đồ cấp ma văn cấu trang sư=Trang Cấu Ma Văn sư cấp Học Đồ
ma văn trung tâm nghiên cứu=Trung tâm nghiên cứu Ma Văn
ma hóa kết tinh=kết tinh ma hóa
nghề nghiệp quyển trục=quyển trục nghề nghiệp
giao dịch nhắc nhở=thông báo giao dịch
kiến trúc bản vẽ=bản vẽ kiến trúc
Lam Sơn công xưởng=công xưởng Lam Sơn
hàng giảm giá thực đơn bên trong=trong danh sách hàng giảm giá
hàng giảm giá thực đơn=danh sách hàng giảm giá
phổ thông phẩm chất=phẩm chất Phổ Thông
Sparta các dũng sĩ=các dũng sĩ Sparta
tinh xảo vật liệu=vật liệu tinh xảo
ở chỗ này=ở đây
ngươi làm sao=sao ngươi
một viên trứng=một quả trứng
hồn tinh số lượng=số lượng hồn tinh
chuyên gia cấp=cấp Chuyên Gia
đại sư cấp=cấp Đại Sư
Thánh cấp=cấp Thánh
thánh rèn đúc sư=thợ rèn cấp Thánh
am hiểu lĩnh vực=lĩnh vực am hiểu
thật tốt dưỡng thương=dưỡng thương thật tốt
cái kia ta=vậy thì ta
tình huống dưới=dưới tình huống
Thiên Thánh phong=núi Thiên Thánh
ở nơi này=ở đây
ngắn ngủi thời gian một tháng=thời gian một tháng ngắn ngủi
là chuyện gì xảy ra=đã xảy ra chuyện gì
thu hoạch được=nhận được
Không Gian Tinh Thạch=Tinh Thạch Không Gian
tư chất đề thăng đan=Đề Thăng Tư Chất Đan
tu luyện sổ tay=sổ tay tu luyện
một trận lắc lư=lắc lư một trận
một kiện bảo giáp=một món bảo giáp
hạch tâm đệ tử=đệ tử hạch tâm
bí cảnh bên trong=trong bí cảnh
cái đồ đệ=đồ đệ
tu vi hắn=tu vi của hắn
mi đầu=lông mi
một trận hoảng sợ=hoảng sợ một trận
xuất phát trước=trước khi xuất phát
hệ thống tìm tòi đệ tử phạm vi=phạm vi tìm kiếm đệ tử của hệ thống
tại xung quanh của nó=ở xung quanh nó
vì cái gì=vì sao
một đầu Yêu thú=một con Yêu thú
vậy liền=vậy thì
làm sao hiện tại=sao bây giờ
không có cái gì trông thấy=không nhìn thấy gì nữa
trông thấy=nhìn thấy
trong mắt hàn quang=hàn quang trong mắt
trước mắt tất cả=những chuyện trước mắt
Nghĩ không ra=không ngờ
một cái bí cảnh=một bí cảnh
tiến nhập=tiến vào
làm sao chỉ có=sao mà chỉ có
như thế một điểm đồ vật=một chút đồ như vậy chứ
một điểm đồ vật=một chút đồ
như thế một điểm=một chút như vậy
có chút im lặng=không biết nói gì
trong tay tư nguyên=tài nguyên trong tay
tinh huyết một bình=một bình tinh huyết
Vương Đằng thứ ba đồ=Tam đệ tử của Vương Đằng
là thời điểm=là lúc
hệ thống không gian=không gian hệ thống
Bất quá coi như thế=Nhưng cho dù như thế
Tiên Tử phong=núi Tiên Tử
Bạch Khiết trưởng lão=trưởng lão Bạch Khiết
trong tông nhiệm vụ=nhiệm vụ trong tông
lịch luyện nhiệm vụ=nhiệm vụ lịch luyện
bách tông đại hội=đại hội Bách Tông
mát xa đại sư=Mát Xa Đại Sư
thôn phệ thiên=Thôn Phệ Thiên
Thần giai trên nửa phần=cấp Thần, nửa phần trên
Vương Đằng nhị đồ đệ=Nhị đệ tử của Vương Đằng
đến mức=còn về
Nhiên Huyết bí pháp=bí pháp Nhiên Huyết
kỳ quái hoa văn=hoa văn kỳ quái
Thanh Lâm quận thành=quận thành Thanh Lâm
Chí Thánh thư viện=thư viện Chí Thánh
thì liền=ngay cả
sau lưng một đám đệ tử=một đám đệ tử sau lưng
đạo yêu kiều cười=tiếng cười yêu kiều
bên cạnh một đoàn người=một đoàn người bên cạnh
lẳng lặng nhìn=im lặng nhìn
tùy thời phát sinh=xảy ra bất cứ lúc nào
Ta người này=Con người ta
dễ nghe thanh âm=âm thanh dễ nghe
Thượng Cổ Thần Khí=Thần Khí Thượng Cổ
Trung niên nam tử=nam tử trung niên
ngốc cháu trai=chái trai ngốc
nhìn lấy=nhìn
chính mình cháu trai=cháu trai của mình
kích động bộ dáng=bộ dáng kích động
thở dài một cái=thở dài một hơi
ta lần này=lần này ta
theo trong túi=từ trong túi
trấn tà châu=Trấn Ma Châu
kiện vật phẩm=món vật phẩm
cực nhỏ xác suất=xác suất cực nhỏ
một trăm vạn=1 triệu
mười vạn=100 ngàn
Sí liệt ma đạn=Sí Liệt Ma Đạn
giáp đá thuật=Giáp Đá Thuật
cung đệm sắt=Cung Đệm Sắt
Hoàn Vũ lãnh địa=lãnh địa Hoàn Vũ
tinh xảo phẩm chất=phẩm chất Tinh Xảo
hàn ba kiếm=Hàn Ba Kiếm
hàn ba trảm=Hàn Ba Trảm
sương lạnh trảm kích=Hàn Ba Trảm Kích
hàn vảy=Hàn Vảy
skill bị động=Kỹ năng bị động
Thanh hàn khí=Thanh Hàn Khí
Hỏa lân giáp=Hỏa Lân Giáp
Tùng nha kiếm=Tùng Nha Kiếm
hỏa nguyên tố hô hấp=Hơi thở nguyên tố Hỏa
thánh cấp=cấp Thánh
người khẩu=nhân khẩu
Hoàn Vũ thành trấn=thành trấn Hoàn Vũ
một vạn=10 ngàn
một ức=100 triệu
mười ức=1 tỷ
khay bên trong bình ngọc=bình ngọc trên khay
nhiều như vậy linh thạch=nhiều linh thạch như vậy
vô tận phiền phức=phiền phức vô tận
kịch liệt cạnh tranh=cạnh tranh kịch liệt
ít như vậy linh thạch=ít linh thạch như vậy
nhị lưu thế lực=thế lực nhị lưu
tam lưu thế lực=thế lực tam lưu
lạnh hừ=hừ lạnh
còn có hay không muốn ra giá?=còn có ai muốn ra giá hay không?
thực sự=thật sự
nhất định muốn=nhất định phải
về sau=sau này
thủ tục phí=phí thủ tục
lẫn nhau liếc nhau=liếc nhìn nhau
nhưng là sư tôn=nhưng sư tôn
nhưng là=nhưng
hắn sau lưng=sau lưng hắn
nói đến cũng=nói cũng
thực lực bọn họ=thực lực của bọn họ
xác thực quá yếu=đúng là quá yếu
bình thường người=người bình thường
đạo vết thương=vết thương
sư huynh đệ hai người=hai sư huynh đệ này
ổn trọng tâm thái=tâm thái ổn trọng
tùy thời thời cơ xuất thủ=lựa chọn thời cơ xuất thủ
nhanh nhẹn thân pháp=thân pháp nhanh nhẹn
Mã đức=mẹ nó
Vừa mới trận=trận vừa rồi
cảm giác được=cảm thấy
nhẹ nhõm giải quyết=giải quyết nhẹ nhàng
Tiếp xuống trận chiến đấu này=trận chiến đấu tiếp theo
một bên nói một bên=vừa nói vừa
một bên cười một bên=vừa cười vừa
một bên đi một bên=vừa đi vừa
một bên chạy một bên=vừa chạy vừa
Trên thân=trên người
tin tức nhắc nhở=thông báo nhắc nhở
chưa đọc tin tức=thông báo chưa đọc
nhất định xác suất=xác suất nhất định
Sparta thuẫn chiến sĩ=thuẫn chiến sĩ Sparta
Sparta quan truyền lệnh=quan truyền lệnh Sparta
Sparta hành khúc=hành khúc Sparta
Sparta chiến trận=chiến trận Sparta
Sparta chiến kỹ=chiến kỹ Sparta
Sparta hình bóng=Chiến binh bóng tối Sparta
theo sau lưng=từ sau lưng
biến mất tại nguyên chỗ=đột nhiên biến mất
càng chuẩn xác mà nói=nói đúng hơn
tại lĩnh vực phạm vi bên trong=ở trong phạm vi lĩnh vực
cường đại chiêu thức=chiêu thức cường đại
Gian phòng bên trong=trong gian phòng
theo trên chỗ ngồi đứng dậy=đứng dậy khỏi chỗ ngồi
cảnh một tầng=cảnh tầng một
cảnh hai tầng=cảnh tầng hai
cảnh ba tầng=cảnh tầng ba
cảnh bốn tầng=cảnh tầng bốn
cảnh năm tầng=cảnh tầng năm
cảnh sáu tầng=cảnh tầng sáu
cảnh bảy tầng=cảnh tầng bảy
cảnh tám tầng=cảnh tầng tám
cảnh chín tầng=cảnh tầng chín
cảnh mười tầng=cảnh tầng mười
trên thân sát khí=sát khí trên người
còn dạng này=còn như vậy
cùng một chỗ=cùng nhau
Không bằng=hay là
thiên nhiên bí cảnh=bí cảnh thiên nhiên
không có khả năng=không thể nào
bí cảnh lối ra=lối ra bí cảnh
Kỳ thật nói đến=nói thật
cũng minh bạch=cũng hiểu rõ
ngươi tại sao=tại sao ngươi
tùy thời xuất thủ chuẩn bị=chuẩn bị xuất thủ bất cứ lúc nào
trong ánh mắt hàn ý càng sâu=sát ý trong mắt càng đậm
ngươi là làm sao mà=sao ngươi lại biết được
ta cùng sư đệ=ta và sư đệ
ai cũng không biết=không ai biết
đàm phán tư cách=tư cách đàm phán
cách âm trận pháp=trận pháp cách âm
ngươi nếu như=nếu như ngươi
cường đại tông môn=tông môn cường đại
hộ thân đồ vật=đồ vật hộ thân
tại phụ cận tìm tòi=tìm kiếm gần đó
dẫn đội trưởng lão=trưởng lão dẫn đội
trong phòng tình huống=tình huống trong phòng
Bố trí tốt trận kỳ=bố trí trận kỳ xong
công kích ngọc phù=ngọc phù công kích
phòng ngự ngọc phù=ngọc phù phòng ngự
ngăn cản không được=không ngăn cản được 
thần bí trái cây=trái cây thần bí
bí cảnh cửa vào=cửa vào bí cảnh
bình thường đệ tử=đệ tử bình thường
phổ thông đệ tử=đệ tử phổ thông
ta cùng sư huynh=ta và sư huynh
kinh nghi bất định=tràn đầy nghi ngờ
ngài thế nào=ngài sao vậy
có điểm là lạ=có chút lạ
cắt cổ động tác=động tác cắt cổ
không gian truyền tống ngọc phù=ngọc phù truyền tống không gian
Vương giả huyết mạch=huyết mạch Vương giả
huyết mạch thiên phú=thiên phú huyết mạch
kẻ này thân phận=thân phận kẻ này
vương thất con cháu=con cháu vương thất
hoàng vị tranh đoạt=tranh đoạt hoàng vị
những thứ này=những chuyện này
thân phận nguyên nhân=nguyên nhân thân phận
muốn nịnh bợ cường giả=cường giả muốn nịnh bợ
Kỳ thật=Thật ra
cái gì quá đại sự=chuyện gì quá lớn
phong phú lý luận tri thức=tri thức lý luận phong phú
Tỉ như=giống như
hoàng tử bên trong=trong số các hoàng tử
tiền bối ân cứu mạng=ân cứu mạng của tiền bối
Có thể coi là như thế=nhưng cho dù như thế
trước mắt tràng cảnh=cảnh tượng trước mắt
kinh khủng sát ý=sát ý kinh khủng
chiến đấu dấu vết=dấu vết chiến đấu
xung quanh mặt đất=mặt đất xung quanh
mỹ lệ phong cảnh=phong cảnh mỹ lệ
tông môn đại hội=đại hội tông môn
mấy người sư huynh=mấy người sư huynh
sư huynh bọn họ=mấy người sư huynh
đại khái tình huống=tình huống đại khái
đi tới một bên=đi qua bên cạnh
đem hắn thu làm=thu hắn làm
trên người phiền phức=phiền phức trên người
đồ đệ trên người=trên người đồ đệ
có điểm phiền phức=có chút phiền phức
hắn đều sẽ=hắn cũng sẽ
khẩn cấp tránh hiểm=tránh hiểm khẩn cấp
đề phòng ý thức=ý thức đề phòng
ở trên núi tu luyện=tu luyện ở trên núi
Sư tôn lần này=lần này sư tôn
Lạc Vân phong=núi Lạc Vân
chuyên môn dùng để=chuyên dùng để
an toàn trở về=trở về an toàn
không có thể=không thể
tính khí bốc lửa=tính tình nóng nảy
Ngươi đến tột cùng=đến cùng ngươi
chạy không được=không chạy được
liền xem như=cho dù
lời nói bên trong=trong lời nói
bình thường mạnh=mạnh bình thường
nhìn ngươi thiên tư=thấy thiên tư của ngươi
trước mắt lão giả này thực lực=thực lực của lão giả trước mắt này
đều làm không được=cũng không làm được
Lão phu không phải=Không phải lão phu
hắn chỗ lấy một mực=hắn vẫn luôn
ngươi tự nhiên là=ngươi đương nhiên
Cái kia tiền bối=vậy tiền bối
Đại Càn vương triều=Vương Triều Đại Càn
Hắn là làm sao mà=tại sao hắn lại
gặp qua hắn=đã gặp hắn
gấp gáp phủ nhận=vội phủ nhận
thấy qua ta=gặp ta
vô thượng võ học=võ học vô thượng
sau này nếu là=nếu sau này
đế vương chi khí=Đế Vương Chi Khí
khen thưởng âm thanh=âm thanh khen thưởng
Thần giai công pháp=công pháp Thần giai
cấp S đồ đệ=đồ đệ cấp S
trước mắt lão giả này=lão giả trước mắt này
hắn vừa mới=vừa rồi hắn
ngài hiện tại=bây giờ ngài
tự nhiên muốn=đương nhiên phải
sư huynh cùng sư tỷ=sư huynh và sư tỷ
chần chờ mà hỏi=chần chờ hỏi
hắn khả năng đã=có thể hắn đã
như thế phổ biến=phổ biến như thế
thứ tư đồ đệ=đồ đệ thứ tư
hai cái sư huynh=hai sư huynh
so ngươi lớn hơn=lớn hơn ngươi
so ngươi còn muốn nhỏ=còn nhỏ hơn ngươi
xuất sinh đến bây giờ=sinh ra đến nay
xoắn xuýt biểu lộ=biểu lộ xoắn xuýt
Muốn không tìm=có nên tìm
đi nhìn=đi gặp
ngây thơ tiểu tử=tiểu tử ngây thơ
ngươi kiểu nói này=ngươi nói như vậy
đồ nhi sau này=sau này đồ nhi
hai ngày này bên trong=trong hai ngày này
ẩn tàng tự thân khí tức=che giấu khí tức bản thân
Cái này là thật xong=bây giờ xong thật rồi
sư tôn tu vi=tu vi của sư tôn
ẩn thế cường giả=cường giả ẩn thế
chân chính tông môn=tông môn chân chính
tứ đồ đệ=Tứ đệ tử
vi sư hiện tại=bây giờ vi sư
sư tôn trước mặt=trước mặt sư tôn
không lên một chút quan hệ=không có chút liên quan gì
học không đến=không học được 
bảo mệnh thần kỹ=thần kỹ bảo mệnh
Ngươi nếu như=Nếu như ngươi
sau cùng người sống=người sống sau cùng
lớn nhất bên thắng=bên thắng lớn nhất
giáng lâm tiếp theo=tiếp theo giáng lâm
trân quý vô cùng=vô cùng trân quý
tu luyện công pháp=công pháp tu luyện
theo hệ thống không gian bên trong=từ trong không gian hệ thống
xuất ra một=lấy ra một
tuổi trẻ bóng người=bóng người tuổi trẻ
liền tới đến=đã đi tới
một chỗ động phủ trước=trước một động phủ
vải thô áo gai=áo gai vải thô
thâm niên trưởng lão=trưởng lão thâm niên
Lão giả hai mắt=hai mắt lão giả
Ngay tại vừa mới=chính là ngay vừa rồi
đệ tử sáng nay=sáng nay đệ tử
tiếp lấy lại=sau đó hắn lại
trong phòng phát hiện=phát hiện trong phòng
tiếp nhận=nhận lấy
thì nhiều hơn hai bóng người=lại có thêm hai bóng người
Trước hết chạy tới=chạy tới trước nhất
đem chúng ta gọi tới=gọi chúng ta tới
trên tờ giấy nội dung=nội dung trên tờ giấy
trên tờ giấy nội dung xem hết=xem hết nội dung trên tờ giấy
trên tờ giấy viết nội dung=nội dung được viết trên tờ giấy
khác tình huống=tình huống khác
dị thường động tĩnh=động tĩnh dị thường
người tới thực lực=thực lực người tới
theo gật đầu=gật đầu theo
tu vi của ta mặc dù=mặc dù tu vi của ta
an toàn nghĩ=muốn an toàn
không có cáo tri=không thông báo cho
trong gia tộc cường giả=cường giả trong gia tộc
ngày về bất định=chưa biết ngày về
một chút xung quanh=xung quanh một chút
một chút bên cạnh=bên cạnh một chút
làm cái quyết định=có quyết định
phía dưới dãy núi nhỏ=dãy núi nhỏ phía dưới
mấy người trước mắt=trước mắt mấy người
cùng ta tới=đi với ta
thế nào sử dụng=sử dụng thế nào
khốn địch trận pháp=trận pháp khốn địch
công kích trận pháp=trận pháp công kích
hộ tông đại trận=đại trận hộ tông
thật tốt tu luyện=tu luyện thật tốt
không muốn lại ham chơi=không được ham chơi
trên người tư nguyên=tư nguyên trên người
tăng lên tư chất đan dược=đan dược tăng lên tư chất
các ngươi hai cái=hai người các ngươi
học tập của hắn thành quả=thành quả học tập của hắn
đối với hai người nói=nói với hai người
đối với mọi người nói=nói với mọi người
phía sau lưng căn phòng nhỏ=căn phòng nhỏ phía sau lưng
sư môn môn quy=môn quy sư môn
chúng ta sư môn môn quy=môn quy của sư môn chúng ta
kỳ lạ như vậy môn quy=môn quy kỳ lạ như vậy
ma đạo môn phái=môn phái ma đạo
môn phái ma đạo môn quy=môn quy môn phái ma đạo
chúng ta sư môn=sư môn chúng ta
chúng ta sư môn môn quy=môn quy của sư môn chúng ta
không dám tin bộ dáng=bộ dáng không dám tin
vượt cấp chiến đấu=chiến đấu vượt cấp
bị phong ấn thần khí=thần khí bị phong ấn
có quan hệ gì=có liên quan gì
liền vội vàng=vội vàng
ta thật ra=thật ra ta
trọng yếu=quan trọng
trữ vật giới chỉ bên trong=bên trong trữ vật giới chỉ
xuất ra=lấy ra
sư tôn cho đan dược=đan dược sư tôn cho
ta trước kia=trước kia ta
xung quanh linh khí=linh khí xung quanh
công pháp vận chuyển tốc độ=tốc độ vận chuyển công pháp
so trước đó nhanh gấp bội=nhanh hơn trước đó gấp mười lần
tuyệt thế thiên tài=thiên tài tuyệt thế
so ngươi sớm=sớm hơn ngươi
ta hiện tại=bây giờ ta
đồng tình ánh mắt=ánh mắt đồng tình
học tập thiên phú=thiên phú học tập
vi sư hôm nay=hôm nay vi sư
suy tư một hồi=suy nghĩ một chút
học tập không được=không học tập được
ở thể nội=trong cơ thể
kỳ lạ thiên phú=thiên phú kỳ lạ
hắn tu luyện thành quả=thành quả hắn tu luyện
một cái cơ hội=một cơ hội
một trận cơ duyên=một cơ duyên
chánh thức=chính thức
Nghĩ tới cái này=Nghĩ tới đây
Vương Đằng thứ tư đồ=Tứ đệ tử của Vương Đằng
hắn gần nhất=gần đây hắn
thuyền nhỏ bộ dáng=hình dáng thuyền nhỏ
Tỏa Không đại trận=Đại Trận Tỏa Không
bảo mệnh lợi khí=lợi khí bảo mệnh
một kiện=một món
đều có thể=cũng có thể
linh hồn khí tức=khí tức linh hồn
lợi hại võ học=võ học lợi hại
chính đuổi theo=đang đuổi theo
ngài xem như đi ra=cuối cùng ngài cũng đi ra rồi
sư tôn bên cạnh=bên cạnh sư tôn
cái gì cũng nhìn không ra=không nhìn ra cái gì cả
trốn không thoát=không trốn thoát
thuộc về hắn cơ duyên=cơ duyên thuộc về hắn
nơi này cường giả=cường giả nơi này
cường giả số lượng=số lượng cường giả
nơi này cường giả số lượng=số lượng cường giả nơi này
trung niên đại hán=đại hán trung niên
quận thành thủ vệ=thủ vệ quận thành
Nhìn tới nơi này=xem ra ở đây
Trung niên đại hán=đại hán trung niên
kiểm trắc đến phụ cận=kiểm tra thấy gần đây
có một tên tư chất hợp cách đệ tử=có một đệ tử có tư chất hợp cách
trong mắt nghi hoặc=nghi hoặc trong mắt
một chút hình dạng=hình dạng một chút
trước mắt vị tiền bối=vị tiền bối trước mắt
Thánh Viêm Liệt Hồn quạt=Thánh Viêm Liệt Hồn Quạt
bảo mệnh năng lực=năng lực bảo mệnh
môn này bí thuật=môn bí thuật này
ta môn hạ=môn hạ của ta
cái kia thánh địa=Thánh địa kia
ở đây tu luyện=tu luyện ở đây
kim quang lập lòe=lập lòe kim quang
loá mắt vô cùng=vô cùng chói mắt
trang viên xung quanh=xung quanh trang viên
như vậy trận pháp à=trận pháp như vậy không
thành trì bên trong=trong thành trì
thì làm ra quyết định=đã có quyết định
Hắn đều đã tới=Hắn đã tới đây rồi
không tay mà về=ra về tay không
trận pháp mặc dù nhiều=mặc dù nhiều trận pháp
theo tu luyện bên trong=từ trong tu luyện
Vừa mới hắn=Vừa rồi hán
trong trang viên trận pháp=trận pháp trong trang viên
không thể nào sự tình=là chuyện không thể nào
Thiên Lĩnh quận thành=quận thành Thiên Lĩnh
ngay tại vừa mới=ngay vừa rồi
trong trang viên tình huống=tình huống trong trang viên
kinh khủng cự thú=cự thú kinh khủng
to lớn con ngươi màu đen=con ngươi màu đen to lớn
Ngươi bây giờ là tu vi gì=tu vi của ngươi bây giờ là gì
thậm chí càng cao=thậm chí cao hơn
liền hỏi tiếp=đã hỏi tiếp
Nàng lại là thân phận gì=nàng có thân phận gì
nổi lên nói thầm=thầm nhủ
kỳ dị thực vật=thực vật kỳ dị
đáy vực phía dưới=dưới đáy vực
bạch cốt bên trong tàn hồn=tàn hồn bên trong bạch cốt
thần hồn chi lực=lực lượng thần hồn
một trận phun trào=phun trào một trận
trong suốt kiếm khí=kiếm khí trong suốt
sét đánh chi thế=thế như sét đánh
trong suốt trường kiếm=trường kiếm trong suốt
cứng rắn vô cùng=vô cùng cứng rắn
tại trường kiếm dưới=ở dưới trường kiếm của hắn
kiếm khí tốc độ=tốc độ của kiểm khí
các ngươi những người này=mấy người các ngươi
một trận chấn động=chấn động một trận
trên mặt đất vết nứt=vết nứt trên mặt đất
Đây là có chuyện gì=có chuyện gì vậy
làm sao động tĩnh=tại sao động tĩnh
cường giả truyền thừa=truyền thừa cường giả
trong di tích lớn nhất cơ duyên=cơ duyên lớn nhất trong di tích
những cường giả kia truyền thừa=truyền thừa của những cường giả kia
nếu là ở phụ cận=nếu như ở gần
tại phụ cận người=người ở gần đó
cỗ này chấn động=cơn chấn động này
đây là có chuyện gì=có chuyện gì vậy
Tuy nhiên nàng=tuy nàng
cái này truyền thừa=truyền thừa này
ngắn ngủi ba năm=ba năm ngắn ngủi
Nếu là thật sự=nếu như thật sự
truyền ngôn=lời đồn
Thí Luyện Chi Tháp=Tháp Thí Luyện
chúng ta lần này=lần này chúng ta
Tuy nhiên hắn=tuy hắn
lần này truyền thừa=truyền thừa lần này
khả năng không tầm thường=có thể không tầm thường
có nguyên tắc người=người có nguyên tắc
ta cái thứ nhất đến=ta là người đến đầu tiên
trước mắt kiến trúc=kiến trúc trước mắt
giữa không trung đạo thân ảnh=đạo thân ảnh giữa không trung
như là đã=nếu đã
như vậy người=người như vậy
nghĩ không ra=hắn không ngờ
gặp nam tử áo đen=thấy nam tử áo đen
Đánh dấu=Điểm danh
Ngự Lâm cấm vệ=cấm vệ Ngự Lâm
Tinh Không kỵ sĩ=kỹ sĩ Tinh Không
tình không thạch=đá Tinh Không
không thạch tình=thạch tình không
Mộng Yểm Mã=ngựa Mộng Yểm
kịch liệt tranh đoạt=tranh đoạt kịch liệt
nhìn liếc=liếc nhìn
thu được bên trong truyền thừa=thu được truyền thừa trong đó
phản sát=giết ngược lại
màu đỏ thẫm môn hộ=cánh cửa màu đỏ thẫm
hắn thì xuất hiện=hắn đã xuất hiện
to lớn huyết nguyệt=huyết nguyệt to lớn
quỷ dị không rõ khí tức=khí tức quỷ dị không rõ
bên hông túi trữ vật=túi trữ vật bên hông
sờ soạng cái hư không=không sờ trúng cái gì
mình bên hông=bên hông mình
thí luyện thông quan người=người thông qua thí luyện
Hắn tâm niệm nhất động=trong lòng hắn khẽ động
tiếng nói vừa ra=vừa dứt lời
đen nhánh quang mang=quang mang đen nhánh
Lang hình Yêu thú=Yêu thú Sói
ở bên tai của hắn vang lên=vang lên ở bên tai của hắn
dã quái=quái thú hoang dã
Hoàn Vũ thành=thành Hoàn Vũ
thú triều=thủy triều quái thú
Kinh nghiệm thuế=thuế Kinh nghiệm
nguyên tố chúa tể=Chúa Tể Nguyên Tố
nguyên tố chỉ lệnh=Hiệu Lệnh Nguyên Tố
thân cận nguyên tố=Hòa Hợp Nguyên Tố
Gasid lãnh chúa=lãnh chúa Gasid
tất cả có chín tầng=có tổng cộng chín tầng
 a.=.
 a!=!
 a?=?
 a,=,
ta đã thấy,=ta nhìn thấy rồi,
kích động âm thanh=âm thanh kích động
Nhanh điểm,=Nhanh lên,
Cái gì cũng không thấy được=nhưng hắn không thấy gì cả
đã đã hiểu=cũng hiểu
không muốn khiến người khác đi vào=không được để cho người khác đi vào
cái kia động tĩnh khổng lồ=động tĩnh khổng lồ vừa rồi
lần thứ nhất xuất hiện=lần đầu tiên xuất hiện
bảo vật cùng truyền thừa=bảo vật và truyền thừa
còn không có bị=vẫn chưa bị
, coi như=, cho dù
bên trong đã tiến vào=đã tiến vào bên trong
nếu là bị=nếu như bị
lại thu thập các ngươi=sẽ thu thập các ngươi sau
đệ tử ngữ khí=ngữ khí của đệ tử
có chút không xác định=hơi không chắc chắn
cái kia chính là=đó chính là
quá mức bất ngờ=quá bất ngờ
đến có cao=cao đến
trước mắt quái vật khổng lồ=quái vật khổng lồ trước mắt
【 a=【 A
【 b=【 B
【 c=【 C
【 d=【 D
【 đ=【 Đ
【 e=【 E
【 ê=【 Ê
【 g=【 G
【 h=【 H
【 i=【 I
【 k=【 K
【 l=【 L
【 m=【 M
【 n=【 N
【 o=【 O
【 ô=【 Ô
【 ơ=【 Ơ
【 p=【 P
【 q=【 Q
【 r=【 R
【 s=【 S
【 t=【 T
【 u=【 U
【 ư=【 Ư
【 x=【 X
【 v=【 V
【 y=【 Y
[ a=[ A
[ b=[ B
[ c=[ C
[ d=[ D
[ đ=[ Đ
[ e=[ E
[ ê=[ Ê
[ g=[ G
[ h=[ H
[ i=[ I
[ k=[ K
[ l=[ L
[ m=[ M
[ n=[ N
[ o=[ O
[ ô=[ Ô
[ ơ=[ Ơ
[ p=[ P
[ q=[ Q
[ r=[ R
[ s=[ S
[ t=[ T
[ u=[ U
[ ư=[ Ư
[ x=[ X
[ v=[ V
[ y=[ Y
( a=( A
( b=( B
( c=( C
( d=( D
( đ=( đ
( e=( E
( ê=( Ê
( g=( G
( h=( H
( i=( I
( k=( K
( l=( L
( m=( M
( n=( N
( o=( O
( ô=( Ô
( ơ=( Ơ
( p=( P
( q=( Q
( r=( R
( s=( S
( t=( T
( u=( U
( ư=( Ư
( x=( X
( v=( V
( y=( Y
(a=(A
(b=(B
(c=(C
(d=(D
(đ=(Đ
(e=(E
(d=(D
(ê=(Ê
(g=(G
(h=(H
(i=(I
(k=(K
(l=(L
(m=(M
(n=(N
(o=(O
(ô=(Ô
(ơ=(Ơ
(p=(P
(q=(Q
(r=(R
(s=(S
(t=(T
(u=(U
(ư=(Ư
(x=(X
(v=(V
(y=(Y
[a=[A
[b=[B
[c=[C
[d=[D
[đ=[Đ
[e=[E
[ê=[Ê
[g=[G
[h=[H
[i=[I
[k=[K
[l=[L
[m=[M
[n=[N
[o=[O
[ô=[Ô
[ơ=[Ơ
[p=[P
[q=[Q
[r=[R
[s=[S
[t=[T
[u=[U
[ư=[Ư
[x=[X
[v=[V
[y=[Y
\"a=\"A
\"b=\"B
\"c=\"C
\"d=\"D
\"đ=\"Đ
\"e=\"E
\"ê=\"Ê
\"g=\"G
\"h=\"H
\"i=\"I
\"k=\"K
\"l=\"L
\"m=\"M
\"n=\"N
\"o=\"O
\"ô=\"Ô
\"ơ=\"Ơ
\"p=\"P
\"q=\"Q
\"r=\"R
\"s=\"S
\"t=\"T
\"u=\"U
\"ư=\"Ư
\"x=\"X
\"v=\"V
\"y=\"Y
thần bí hạt châu=hạt châu thần bí
bên trong lấy được=lấy được từ trong
Đại Tần đế quốc=đế quốc Đại Tần
Vẫn là nói=Hay là
đưa bảo bối tài tử=hài tử tặng bảo bối
quá xảo hợp=thật sự quá trùng hợp
Trời mới biết=Có trời mới biết
cái gì ngoài ý muốn biến hóa=chuyện ngoài ý muốn gì
khó có thể đối phó=khó đối phó
bình thường phát triển=phát triển bình thường
bên trong là cái tình huống như thế nào=tình huống trong đó như thế nào
coi như hiện tại tiến vào=cho dù bây giờ vào đó
minh bạch=hiểu rõ
phạm vi bên trong=trong phạm vi
mấy chục dặm phạm vi bên trong=trong phạm vi mấy chục dặm
liền vô tác dụng=sẽ vô dụng
một mực là=vẫn luôn là
như thế huyền học tồn tại=một tồn tại kỳ diệu như thế
Ổn thỏa lý do=Tìm được lý do ổn thỏa
vẫn là quyết định=vẫn quyết định
ở bên ngoài bố trí trận pháp=bố trí trận pháp ở bên ngoài
vì chính là hôm nay=chính là vì ngày hôm nay
phạm vi lớn trận pháp=trận pháp phạm vi lớn
Tuy nhiên kích hoạt=Tuy muốn kích hoạt
muốn một chút thời gian=cần tốn một chút thời gian
không gian truyền tống phù=truyền tống phù Không Gian
, vậy tuyệt đối= thì tuyệt đối sẽ
đại trận phạm vi=phạm vi của đại trận
màu đen thổ địa=thổ địa màu đen
trên mặt biểu lộ=vẻ mặt
nào biến hóa=thay đổi nào
Đây tất cả hắn=tất cả những chuyện này, hắn
ở bên ngoài liền đã biết=đã biết từ lúc ở bên ngoài
tin tức trong đầu=thông tin trong đầu
là dạng này=là như vậy
chung chín tầng=có tổng cộng chín tầng
toàn bộ thông quan sau=sau khi thông quan toàn bộ
ta xem một chút=ta xem thử
tiến lên tốc độ=tốc độ tiến lên
ta tiến lên tốc độ=tốc độ tiến lên của ta
mỗi một con khí tức trên người=khí tức trên người mỗi một con
Đây là địa phương nào=Đây là nơi nào
cùng hắn trong tưởng tượng=trong tưởng tượng của hắn
cùng hắn trong tưởng tượng hoàn toàn không giống=hoàn toàn không giống trong tưởng tượng của hắn
có thể sau khi=nhưng sau khi
không có nhìn thấy=không nhìn thấy
bất kỳ vật gì=bất kỳ thứ gì
một đoạn tin tức=một đoạn thông tin
chúng sao ta lại bây giờ=bây giờ chúng ta nên làm gì
không có cho ra trả lời=không lập tức trả lời
ngăn không được=không ngăn được
tại loại cơ duyên này mặt trước=ở trước mắt cơ duyên như thế này
Bọn họ bây giờ có thể làm=Bây giờ, chuyện bọn họ có thể làm
màu trắng môn hộ=cánh cửa màu trắng
băng lãnh âm thanh=âm thanh lạnh lẽo
tầng thứ nhất thí luyện=thí luyện tầng thứ nhất
tầng thứ hai thí luyện=thí luyện tầng thứ hai
tầng thứ ba thí luyện=thí luyện tầng thứ ba
tầng thứ tư thí luyện=thí luyện tầng thứ tư
tầng thứ năm thí luyện=thí luyện tầng thứ năm
tầng thứ sáu thí luyện=thí luyện tầng thứ sáu
tầng thứ bảy thí luyện=thí luyện tầng thứ bảy
tầng thứ tám thí luyện=thí luyện tầng thứ tám
tầng thứ chín thí luyện=thí luyện tầng thứ chín
Tầng thứ nhất thí luyện=Thí luyện tầng thứ nhất
Tầng thứ hai thí luyện=Thí luyện tầng thứ hai
Tầng thứ ba thí luyện=Thí luyện tầng thứ ba
Tầng thứ tư thí luyện=Thí luyện tầng thứ tư
Tầng thứ năm thí luyện=Thí luyện tầng thứ năm
Tầng thứ sáu thí luyện=Thí luyện tầng thứ sáu
Tầng thứ bảy thí luyện=Thí luyện tầng thứ bảy
Tầng thứ tám thí luyện=Thí luyện tầng thứ tám
Tầng thứ chín thí luyện=Thí luyện tầng thứ chín
mà nói,=thì
cái gì độ khó khăn=độ khó nào
tối đa cũng cũng là=tối đa chỉ là
tiêu hao một số linh lực=tiêu hao một chút linh lực
ngưu yêu=Ngưu Yêu
thân bên trên=trên người
tán phát lấy=tỏa ra
liếc mắt một liền nhận ra=liếc mắt một cái đã nhận ra
lực lớn vô cùng=lực lượng cực kỳ lớn
Tại cùng cảnh giới bên trong=Trong cùng cảnh giới
Mà lại trước mắt=Mà trước mặt hắn lại
suy nghĩ nhiều thời gian=nhiều thời gian suy nghĩ
song phương=hai bên
không có lần nữa xuất kích=không tiếp tục xuất kích nữa
hướng phía sau thối lui=lui về phía sau
tuyệt thế vô song tốc độ=tốc độ tuyệt thế vô song
không muốn thả bất luận cái gì người tiến đến=không được cho bất cứ ai đi vào
thủ không được=không thủ được
khiến người khác đi vào=để cho người khác đi vào
Không muốn cậy mạnh=Không được cậy mạnh
cùng ta đi vào chung=đi vào với ta
kinh nghiệm rất nhiều=rất nhiều kinh nghiệm
hỏa chủng=Hỏa Chủng
Cái này cũng được sao=Như vậy cũng được à
Oành!=Đùng!
vệt kim quang=quầng sáng màu vàng
chúng ta mấy cái=mấy người chúng ta
toàn bộ lấy đi=lấy đi hết
Đại ca tuy nhiên=Tuy đại ca
nhưng làm sao có thể=nhưng sao có thể
đều không muốn ầm ĩ=đừng ầm ĩ nữa
cái này thí luyện=thí luyện này
hay không ngăn cản ta=ngăn cản ta hay không
toàn thân da thịt=da thịt toàn thân
đỏ thẫm vô cùng=vô cùng đỏ thẫm
Hắn sau lưng=Sau lưng hắn
Liền để ta xem=Để ta xem thử
chỉ là nhẹ nhàng một bên=chỉ nhẹ nhàng né qua bên cạnh
kinh khủng phong lôi âm thanh=âm thanh phong lôi kinh khủng
liền thành công=đã thành công
cũng không có cái gì khác biệt=cũng không khác gì
chân chính thân thể=thân thể chân chính
cùng chân chính thân thể cũng không có cái gì khác biệt=cũng không khác gì thân thể chân chính
phí tổn thời gian không dài=không tốn quá nhiều thời gian
tiêu hao linh lực lại không ít=lại tiêu hao không ít linh lực
Vô luận là=cho dù là
phi hành võ kỹ=võ kỹ phi hành
Hắn tuy nhiên=tuy hắn
sự tình này=chuyện này
xuất hiện tại=xuất hiện ở
thật nhanh thối lui=nhanh chóng lui lại
nhanh chóng lui lại=nhanh chóng lui về phía sau
ngươi sao lại ra làm gì=sao ngươi lại ra sớm như vậy
Mất mặt a=Quá mất mặt
hắn vậy mà là=hắn lại là
cái thứ nhất đi ra=người đi ra đầu tiên
uyển chuyển bóng người=bóng người uyển chuyển
Ngay tại đây là=Ngay sau đó
bên trong tình huống=tình huống bên trong
trong nháy mắt lĩnh ngộ=lập tức lĩnh ngộ
Ba người ánh mắt=Ánh mắt ba người
đan vào một chỗ=đan vào nhau
so ta trước đi ra=đi ra ngoài trước ta
đem tình huống bên trong nói=nói tính huống bên trong
họ lục sư muội=sư muội họ Lục
vừa mới xảy ra một màn=một màn vừa mới xảy ra
bao nhiêu thời gian=bao lâu nữa
nhẹ gật gật đầu=nhẹ gật đầu
Đến nhiều người=Nhiều người đến đây
không có tiêu tán=không tiêu tán
làm sao bây giờ?=thì phải làm sao?
rất có thể sự tình=chuyện rất có thể xảy ra
như vậy đi vào=đi vào như vậy
hướng nơi này chạy đến=chạy về hướng này
đối với hai đồ đệ nói=nói với hai đồ đệ
Đúng, sư tôn=Vâng, sư tôn
cầm đầu đại hán=đại hán cầm đầu
còn lại bốn tráng hán=bốn tráng hán còn lại
theo trên người=từ trên người
Hiện tại cho=hiện tại, ta cho
đem các ngươi đánh=đánh các ngươi
Không có việc gì liền tốt=Không sao là tốt rồi
không có gì liền tốt=không sao là tốt rồi
tiện tay một kích=một kích tiện tay
ta tiện tay một kích=một kích tiện tay của ta
có lời nói thật tốt nói=có gì từ từ nói
chúng ta liền đi qua=chúng ta sẽ đi qua ngay
mấy cái đệ đệ=mấy đệ đệ
không được bao lâu=không lâu nữa
liền có thể đến=sẽ đến rồi
trận sương mù=làn sương mù
Chuyện gì xảy ra=Xảy ra chuyện gì vậy
làm sao đột nhiên=sao đột nhiên
lên lớn như vậy sương mù=lại có sương mù dày như vậy
Ba người bước chân=Bước chân ba người
nhất thời thì ngừng lại=lập tức dừng lại
những địa phương khác=những nơi khác
có thể cũng chỉ=nhưng cũng chỉ
không muốn tách ra=không được tách ra
khác thiếu niên=thiếu niên khác
, thì hắn biết= chỉ có hắn biết
như thế nhìn=nhìn như thế
hiện tại tình huống này=với tình huống bây giờ
cao hứng không nổi=không cao hứng nổi
đối diện bốn người=bốn người đối diện
đệ tử trên mặt=trên mặt của đệ tử
Bọn họ vì sao=Vì sao bọn họ
ở chung quanh bố trí trận pháp=bố trí trận pháp ở xung quanh
đem chúng ta khốn trụ=khốn trụ chúng ta
không có những người khác=không còn ai khác
trên người túi trữ vật=túi trữ vật trên người
trên tay mang giới chỉ=giới chỉ trên tay
đều xem hiểu lẫn nhau trong ánh mắt ý tứ=hiểu rõ ý tứ trong mắt lẫn nhau
chúng ta hai cái=hai người chúng ta
chân chính tinh túy=tinh túy chân chính
còn không có học được=vẫn chưa học được
vô cực tông=Vô Cực tông
đụng không thấy=không gặp được
Cái này cũng=chuyện này cũng
Vì lấy phòng ngừa=Vì để phòng ngừa
đệ tử bên cạnh=bên cạnh đệ tử
một chút mặt đất=mặt đất một chút
trống rỗng bên hông=bên hông trống rỗng
đây là cần phải=chuyện này là chuyện nên làm
dư thừa tư nguyên=tư nguyên dư thừa
đem túi trữ vật bên hông lấy=lấy túi trữ vật bên hông
các ngươi đâu?=các ngươi thì sao?
Muốn là bọn họ vừa mới=Nếu như vừa rồi bọn họ
một mảnh trong rừng cây=trong một cánh rừng
màu tím da lông=da lông màu tím
màu trắng đường vân=đường vân màu trắng
chủng tộc thiên phú=thiên phú chủng tộc
lông mi thì nhíu lại=lông mi hơi nhíu lại
ở trên bầu trời phi hành=phi hành ở trên bầu trời
công kích kẻ địch=tấn công kẻ địch
Sưu!=Vù!
một trận thít chặt=híp lại thật chặt
Ngay tại lúc này=đúng vào lúc này
một đôi tựa như ảo mộng cánh=một đôi cánh như mộng ảo
nhẹ nhàng một động=nhẹ nhàng đập một cái
không có nắm chắc=không nắm chắc
Dù là thân ảnh=Nhưng dù thân ảnh
tràn ngập lửa giận ánh mắt=ánh mắt tràn ngập lửa giận
thiểm điện công kích=công kích thiểm điện
giờ đến phiên ta=bây giờ đến lượt ta
ngưng tụ tại sau lưng=ngưng tụ sau lưng hắn
hỏa quang ngập trời=ánh lửa ngập trời
Oanh...=Đùng...
nóng rực khí lãng=khí lãng nóng rực
về hướng bầu trời phun bắn đi=bắn lên trên bầu trời
phía dưới rừng cây=rừng cây phía dưới
tại nghỉ ngơi tại chỗ=nghỉ ngơi tại chỗ
tại mặt đất màu đỏ sậm phía trên=phía trên mặt đất màu đỏ sậm
Hắn lúc này quần áo=lúc này, quần áo của hắn
Hắn lúc này=lúc này, hắn
tóc đã không có=tóc đã không còn
May ra, hắn=may mà hắn đã
Còn không đợi=nhưng không đợi
, hắn liền bị= thì đã bị
người đánh ngất xỉu=người khác đánh ngất xỉu
động tác một mạch mà thành=động tác cực kỳ thành thạo
hắn khả năng=có thể hắn đã
nơi này làm sao=sao nơi này
tại đối phó=đang đối phó với
Cả ngày đã biết=cả ngày chỉ biết
trước kia cũng không=trước kia ngươi không
làm sao từ khi=tại sao từ khi
sau này, thì=thì ngươi lại
dạng này rồi?=như vậy rồi?
trong lòng rất là không hiểu=trong lòng hắn rất không hiểu
Bất quá, hắn mới lên tiếng nói=nhưng mà hắn vẫn lên tiếng nói
không có chuyện gì=không sao
hiện tại ngay tại=bây giờ đang
đối với bên cạnh mấy cái người nói=nói với mấy người bên cạnh
Muốn không phải nhìn nàng=nếu không phải nàng
bộ tông chủ con gái=con gái của tông chủ
dạng này nuông chiều=nuông chiều như vậy
chờ ta một chút nhóm=chờ mấy người chúng ta một chút
lại tiến tới một=lại có một người tiến vào
liền dạng này đại mỹ nữ=ngay cả đại mỹ nữ như vậy
ném thì ném=ném là ném
lại là cái gì kết cục=sẽ có kết cục gì
cái gì kết cục=kết cục gì
mấy người bọn họ sau cùng=sau cùng mấy người bọn họ
Mà lại hắn cũng=Mà hắn cũng
một kích liền có thể=một kích đã có thể
liền muốn=thì phải
Nhớ lấy không muốn bại lộ thân phận=nhớ kỹ, không được bại lộ thân phận
không muốn bại lộ=không được bại lộ
tin nhắn nhắc nhở=thông báo nhắc nhở
Vương Giả Đơn Vị=đơn vị Vương Giả
cái này không vội=chuyện này không vội
chế tác=chế tạo
luống cuống vô cùng=vô cùng luống cuống
ở chỗ nào=ở đâu
hả hê vô cùng=vô cùng hả hê
rời đi nơi đây=rời khỏi đây
kim quang=ánh sáng màu vàng
Anh Hùng Đơn Vị=đơn vị Anh Hùng
uể oải vô cùng=vô cùng uể oải
Đánh dấu thành công=Điểm danh thành công
đĩa ném Từ Phù=đĩa bay Từ Phù
Đĩa ném Từ Phù=Đĩa bay Từ Phù
rèn đúc sư=thợ rèn
Công năng=chức năng
Công xưởng Lam Sơn=Công Xưởng Lam Sơn
cột trụ Đồ Đằng=Đồ Đằng Trụ
trụ Đồ Đằng=Đồ Đằng Trụ
Lĩnh dân=Lãnh dân
Truyền tấn thủy tinh=Thủy Tinh Truyền Tấn
thức tỉnh mô giới=vật dẫn thức tỉnh
thực nhân ma=Thực Nhân Ma
Rèn đúc sư=thợ rèn
sẽ sản sinh=sẽ sinh ra
Anh Linh Điện=điện Anh Linh
Anh Linh Hồn Ấn=Hồn Ấn Anh Linh
Anh Linh Đơn Vị=Đơn Vị Anh Linh
thay chúng ta báo thù=báo thù cho chúng ta
buồn nôn cực kỳ=cực kỳ buồn nôn
giãy dụa=giãy giụa
tiến công lãnh địa=tấn công lãnh địa
U Hồn Triệu Hoán=Triệu Hoán U Hồn
liền gửi đến=lập tức gửi đến
kích hoạt video=bấm mở video
kiến trúc thô ráp=kiến trúc thô sơ
liền hóa thành=đã hóa thành
tìm tòi nhân khẩu=tìm kiếm nhân khẩu
bán tốc độ=tốc độ bán
khả năng đến hoa=có thể phải tốn
không nhỏ một quãng thời gian=một quãng thời gian không nhỏ
Toàn bộ bán ra=Muốn bán ra hết
công tác đi=công việc đi
tại nơi này=ở đây
khó coi vô cùng=vô cùng khó coi
vẻ mặt không biến hóa=vẻ mặt không thay đổi chút nào
Triều dâng Vong Linh=Triều Dâng Vong Linh
Ý thức thế giới=Ý Thức Thế Giới
Ý thức Thế giới=Ý Thức Thế Giới
Thế giới=thế giới
Con của Khí vận=khí vận chi tử
trận pháp tạo nghệ=tạo nghệ trận pháp
ung dung nụ cười=nụ cười ung dung
trận đạo tạo nghệ=tạo nghệ trận đạo
thế mà đến=đã đạt đến
trình độ như vậy=trình độ này
cái này tuyệt đối=chuyện này tuyệt đối
hắn mắt=hai mắt của hắn
như chuông đồng=trừng to như chuông đồng
đầu đầy mồ hôi=trên trán chảy đầy mồ hôi
chẳng thể nghĩ tới=không ngờ được rằng
lâu như thế thời gian=thời gian lâu như thế
bất hạnh tin tức=tin không tốt
nói cho ngươi=nói với ngươi
thật muốn bị nhốt=thật sự bị nhốt
tràn đầy nghiêm túc=cực kỳ nghiêm túc
trong trận pháp linh thạch=linh thạch trong trận pháp
tiêu hao thời gian quá dài=tốn quá nhiều thời gian
cái này tuyệt đối=đây tuyệt đối
vì chính là=chính là đùng để
nhẫn nại tính tình=cố gắng nhẫn nại
truyền tin ngọc phù=ngọc phù truyền tin
hướng phía sau chạy tới=chạy về phía sau
coi ta sợ các ngươi không thành=tưởng rằng ta sợ các ngươi hay sao
mới vết thương=vết thương mới
thật coi ta là dễ khi dễ không thành=tưởng ta dễ khi dễ hay sao
vô hình kình khí=kình khí vô hình
cái gì cũng nhìn không thấy=không nhìn thấy cái gì cả
so ra kém=kém hơn
hắn đem ánh mắt=ánh mắt của hắn
Trước thu lại=Cứ thu lại trước
đem ba kiện đồ vật thu=thu ba món đồ đó
thì cái gì cũng không biết=đã không biết gì nữa
mây bay nước chảy=như nước chảy mây bay
xem xét cũng là=xem ra đã
là chuyên nghiệp cấp bậc=đã luyện đến chuyên nghiệp
, dẫn theo thân thể= kéo theo thân thể
cần phải thì thừa=chỉ còn lại
ngươi thế nào?=ngươi sao vậy?
xuất thủ gia hỏa=gia hỏa xuất thủ
bọn họ mười mấy người=mười mấy người bọn họ
ngươi nhìn,=ngươi xem,
như vậy bị chế phục=bị chế phục như vậy
không có xuất hiện=không xuất hiện
Nhưng vẫn là bị=Nhưng vẫn bị
Vương thị năm kiệt=Vương Thị Ngũ Kiệt
nói ra:=nói:
chạy ra nơi này=thoát khỏi nơi này
ngay trước người ta mặt nói ra=nói ra ngay trước mặt người ta được
ta đã biết=ta biết rồi
hiện tại chúng ta xác thực=bây giờ chúng ta đúng là
rời đi nơi này=rời khỏi đây
thật có nghiêm trọng như vậy?=thật sự nghiêm trọng như vậy sao?
so với hắn muốn thấp=thấp hơn hắn
tại trận pháp nhất đạo=trên trận pháp nhất đạo
chỗ này trận pháp=trận pháp ở đây
ta thấy không thấu=ta nhìn không thấu
không hề tiếp tục nói=không nói tiếp nữa
sống sót tỷ lệ=tỷ lệ sống sót
chúng ta sống sót tỷ lệ=tỷ lệ sống sót của chúng ta
, dạng này=, như vậy
tại trận pháp bên ngoài=ở bên ngoài trận pháp
trước mặt trận pháp=trận pháp trước mặt
không có tin tức truyền tới=không truyền tin tức tới
Hắn trong lúc nhất thời=trong lúc nhất thời, hắn
nên không nên đi vào=có nên đi vào hay không
thì tại phía trước=ở ngay phía trước
ngăn ở trước mặt=chặn ở trước mặt
chúng ta cái kia đi vào sao=chúng ta có nên đi vào không
một chỗ trong sơn cốc=trong một sơn cốc
phòng ngự lực=lực phòng ngự
linh hoạt vô cùng=vô cùng linh hoạt
Mà lại bọn họ sẽ=mà bọn họ lại
tại cùng cảnh bên trong=ở trong cùng cảnh giới
một đối một dưới tình huống=dưới tình huống một đối một
hướng hắn đập tới=đập về phía hắn
hướng hắn vọt tới=vọt về phía hắn
không màu kiếm khí=kiếm khí không màu
tràn ngập nguy hiểm lên=cực kỳ nguy hiểm
kinh khủng kiếm ý=kiếm ý kinh khủng
về hướng hắn đánh tới=đánh về hướng hắn
tu luyện tư nguyên=tư nguyên tu luyện
nhưng nếu là=nhưng nếu như
lúc nào cũng có thể đi ra=có thể đi ra ngoài bất cứ lúc nào
trong lòng tâm tư=tâm tư trong lòng
mình bố trí trận pháp=trận pháp mình bố trí
những người kia lực lượng=lực lượng của những người kia
Nhưng mà đây=nhưng chuyện này
cơ hồ là là chuyện=gần như là chuyện
băng lãnh âm thanh=âm thanh lạnh lùng
hướng xung quanh nhìn=nhìn xung quanh
đẩy ra cửa phòng=đẩy cửa phòng ra
về hướng trong phòng nhìn qua=nhìn thoáng vào trong phòng
tiền bối truyền thừa=truyền thừa của tiền bối
Muốn không phải=nếu không phải
không thể nào sự tình=chuyện không thể nào
cuối cùng truyền thừa=truyền thừa cuối cùng
Ngay tại tay của hắn=ngay khi tay của hắn
một chỗ trong di tích=ở trong một di tích
phía dưới nửa phần=nửa phần phía dưới
bản tọa thi thể=thi thể bản tọa
hoàn chỉnh truyền thừa=truyền thừa hoàn chỉnh
ngọc giản phía trên=trên ngọc giản
trên nửa phần=nửa phần trên
trước mắt lò luyện đan=lò luyện đan trước mắt
âm trầm âm thanh=âm thanh âm trầm
bên tai vang lên=vang lên bên tai
tướng ta trấn áp=trấn áp ta
hủy ta nhục thân=hủy nhục thân của ta
ngươi tiểu gia hỏa=tiểu gia hỏa ngươi
Đây là vật gì?=đây là cái gì?
tương tự tình huống=tình huống tương tự
Tuy nhiên trong đầu=tuy trong đầu
trong đầu bảo vật=bảo vật trong đầu
trong đầu vang lên=vang lên trong đầu
sẽ có bảo vật như vậy=lại có bảo vật như vậy
cầu van ngươi=cầu xin ngươi
cũng là thở dài=cũng thở dài
Coi như đi qua nhiều năm=cho dù trải qua nhiều năm
tựa như một vị khán giả=giống như một người khán giả
Ta tại sao muốn=tại sao ta phải
vừa rồi không phải=không phải vừa rồi
Hiện tại làm sao=sao bây giờ lại
ta tuyệt sẽ=ta tuyệt đối sẽ
này lấy oán báo ân sự tình=chuyện lấy oán báo ân này
lời thề son sắt nói=thề son sắc
ngươi thả ta sau khi=sau khi ngươi thả ta
Tuy nhiên cái này đề nghị=Tuy đề nghị này
cái bóng đen này=hắc ảnh này
Lão phu cho dù chết=cho dù lão phu có chết
giữa hai người ân oán=ân oán giữa hai người
cái nào nghĩ đến=nhưng ai ngờ
ma đạo tông môn=tông môn ma đạo
như vậy hạnh phúc sinh hoạt=sống hạnh phúc như vậy
tuy nhiên vận khí=tuy vận khí của hắn
bên cạnh tự nhiên=bên cạnh đương nhiên
chạy trốn kỹ xảo=kỹ xảo chạy trốn
Trăm năm thời gian=Thời gian trăm năm
Vua Sư tử=Vua Sư Tử
Người Hồ ly=Người Hồ Ly
Thành Kỳ tích=thành Kỳ Tích
Ma pháp=ma pháp
Đồ đằng=đồ đằng
Lãnh dân=lãnh dân
Kiến tạo=kiến tạo
Dân bản địa=dân bản địa
Lão Pháp sư=lão pháp sư
Sứ thần=Sứ Thần
các Pháp sư=các pháp sư
Sinh linh=sinh linh
Hành tinh Ma Thần=Ma Thần Tinh
Thần quốc=Thần Quốc
Thiên nhãn=Thiên Nhãn
Thành trên không=thành Trên Không
Lực lượng Anh hùng=Lực Lượng Anh Hùng
càng thêm xinh đẹp=xinh đẹp hơn
Là cái nam nhân=là một nam nhân
cần phải đều ưa thích=chắc chắn ai cũng ưa thích
mười bảy mười tám tuổi thiếu niên=thiếu niên mười bảy mười tám tuổi
đỉnh phong thời kỳ=thời kỳ đỉnh phong
có thể kém xa=thì kém xa
người không ra người quỷ không ra quỷ dáng vẻ=dáng vẻ người không ra người quỷ không ra quỷ
nhưng tại nghe xong=nhưng sau khi nghe xong
phong phú nhân sinh kinh lịch=trải nghiệm nhân sinh phong phú
không muốn nếm thử=không nên thử
cá nhân vận khí=vận khí cá nhân
Hắn đã được đến=Hắn đã có được
hoàn toàn không cần thiết=hắn hoàn toàn không cần phải
nếm thử tu luyện=tu luyện thử
Trọng yếu nhất=quan trọng nhất
chỗ này di tích=di tích này
Cái này ta=chuyện này ta
tốt hơn sống sót=sống sót được
tùy thời bị vứt=bị vứt bỏ bất cứ lúc nào
Cái này di tích bên trong=trong di tích này
hao phí giá cả to lớn=trả giá to lớn
tuy nhiên cái kia một nửa thần hồn=tuy một nữa thần hồn đó
chủ nhân xin yên tâm=xin chủ nhân yên tâm
trước mắt trận pháp=trận pháp trước mắt
quá lớn hiệu quả=hiệu quả quá lớn
Đúng,=Vâng
về hướng nơi xa mau chóng đuổi theo=nhanh chóng chạy về nơi xa
, hắn như thế nào lại= sao hắn lại
tại cái này địa phương=ở nơi như thế này
màu vàng kim quyền ảnh=quyền ảnh màu vàng kim
phía xa trên mặt đất=trên mặt đất phía xa
theo trên mặt đất=từ mặt đất
hắn hiện tại tánh mạng=bây giờ tính mạng của hắn đang bị
vừa mới cám ơn ngươi=vừa rồi cảm ơn ngươi
Vừa mới nếu không phải=vừa rồi, nếu không phải
mà lại nơi này=mà nơi này lại
, đứng tại= đang đứng
Nhưng cái này=nhưng chuyện này
bình tĩnh tới cực điểm âm thanh=âm thanh cực kỳ bình tĩnh này
Cơ hồ trong nháy mắt=gần như trong nháy mắt
đầy trời biển lửa=biển lửa ngập trời
theo trong=từ trong
một quyền đánh ra=đánh ra một quyền
Vô hình khí lãng=Khí lãng vô hình
về hướng xung quanh khuếch tán mà đi=lan rộng ra xung quanh
theo thể nội=từ trong cơ thể
nhưng mà lại=nhưng hắn lại
kinh dị khí tức=khí tức kinh dị
Không có việc gì=không sao
Oanh tạc âm thanh=tiếng nổ tung
ngày xưa cừu nhân=cừu nhân ngày xưa
coi ta sợ ngươi sao!=tưởng là ta sợ ngươi à?
nóng rực vô cùng nhiệt độ=nhiệt độ vô cùng nóng rực
kinh khủng nhiệt độ cao=nhiệt độ cao kinh khủng
cao như vậy nhiệt độ=nhiệt độ cao như vậy
hay không bị nướng chín=bị nướng chín hay không
Hai người thân thể=thân thể hai người
Hắn vừa mới=vừa rồi hắn
hiếm có thiên kiêu nhân vật=nhân vật thiên kiêu hiếm có
ngươi không phải nói=không phải ngươi nói
sắc bén vô cùng=vô cùng sắc bén
phương húc=Phương Húc
Ngươi cái đần độn=ngươi ngu vừa thôi chứ
so hắn thấp=thấp hơn hắn
mới có thể đến=nữa mới tới
ma đạo môn nhân=môn nhân Ma Đạo
cùng bọn hắn liều mạng=liều mạng với bọn hắn
Các ngươi hai cái=hai người các ngươi
quang hoa lóe lên=lóe lên quang hoa
quang mang bên trong=trong quang mang
Thế mà lại=Không ngờ lại
khắp nơi có thể thấy được=có thể thấy được khắp nơi
Hắn vậy mà=hắn lại
trùng điệp ngã rơi=ngã mạnh
lấy sét đánh không kịp bưng tai chi thế=lấy thế sét đánh không kịp bưng tai
nghiền ép chi thế=thế nghiền ép
Có thể ai có thể nghĩ tới=nhưng ai mà ngờ được rằng
một tiếng kinh hô=kinh hô một tiếng
Kiến trúc chuyển hóa=Kiến Trúc Chuyển Hóa
Huyết mạch Thiên phú=thiên phú huyết mạch
Cửa Phi thăng=Cửa Phi Thăng
Vạn giới Chư thiên=Chư Thiên Vạn Giới
Nguyên thạch hư không=Nguyên Thạch Hư Không
liệu thương đan dược=đan dược liệu thương
Hộ thân bảo vật=bảo vật hộ thân
cái gì thời điểm=đến lúc nào
hướng phía sau cực tốc bay đi=bay nhanh về phía sau
Muốn chạy trốn?=muốn chạy trốn sao?
vừa mới khí tức=khí tức vừa rồi
mấy hơi thời gian=thời gian mấy hơi thở
tích phân=điểm
Ô lân báo=báo Ô Lân
Ô Lân Báo=báo Ô Lân
Chí Lý Hội=Hội Chí Lý
Tinh Ngân lãnh chúa=lãnh chúa Tinh Ngân
lãnh chúa đỉnh cấp=lãnh chúa đứng đầu
Anh linh điện=điện Anh Linh
vô hình phong lưu=phong lưu vô hình
binh chủng kiến trúc=kiến trúc binh chủng
binh chủng số lượng=số lượng binh chủng
ngoài ngạch bện=Ngoại Ngạch Bện
sau này nếu như=nếu như sau này
phong tín thạch=Phong Tín Thạch
huyết tủy thạch=Huyết Tủy Thạch
cộng hưởng chi phong=Cộng Hưởng Chi Phong
Kẻ địch nếu như=nếu như kẻ địch
huyết tủy sôi trào=Huyết Tủy Sôi Trào
toàn diện tăng lên=tăng lên toàn diện
nhường bọn họ=giúp bọn họ
giảm giá nhân khẩu=nhân khẩu giảm giá
[ là ] [ không ]=[ Có ] [ Không ]
Xác nhận sau khi=sau khi xác nhận
sườn núi bên dưới=bên dưới sườn núi
đĩa ném=đĩa bay
huấn luyện vì là=huấn luyện thành
Này mới đến lãnh dân=lãnh dân mới đến này
để trống chức vụ=chức vụ còn trống
nhân khẩu đăng ký=đăng ký nhân khẩu
phổ thông lãnh dân=lãnh dân phổ thông
huấn luyện chi phí=chi phí huấn luyện
muốn cao một chút=cao hơn một chút
đem thêm ra=sẽ có thêm
ngài hào quang=hào quang của ngài
phảng phất liền nhìn thấy=giống như nhìn thấy
Tôn kính lãnh chúa đại nhân=lãnh chúa đại nhân tôn kính
Đơn giản trò chuyện sau=sau khi trò chuyện đơn giản
vương giả đơn vị=đơn vị Vương Giả
ôn hòa nụ cười=nụ cười ôn hòa
mới sinh ra anh hùng=anh hùng mới sinh ra
nghe không được=không nghe được
từng nói qua=đã từng nói
Trái tim của Lãnh chúa=Lãnh Chúa Chi Tâm
Trái tim thành tâm thành ý=Trái Tim Thành Tâm Thành Ý
Tôn kính đại nhân=đại nhân tôn kính
vì ngươi chuẩn bị=chuẩn bị cho ngươi
Ngươi thu được=ngài nhận được
trong nháy mắt tỉnh táo=lập tức tỉnh táo lại
Phảng phất=giống như
về hướng hắn bước nhanh đi tới=bước nhanh về phía hắn
Tựa hồ=giống như
Sparta chi vương=Vương của Sparta
quyết chí thề chi phong=Quyết Chí Thề Chi Phong
phá quân tư thế=Tư Thế Phá Quân
chiến đấu xung phong=xung phong chiến đấu
hoàn toàn đánh bại=đánh bại hoàn toàn
bất tử chi thân=Thân Thể Bất Tử
bất hủ chi ủng=Trở Thành Bất Hủ
thần cấp binh chủng đơn vị=đơn vị binh chủng cấp Thần
, vẫn là=, hay là
quần thể tăng cường kỹ năng=kỹ năng tăng cường quần thể
tại chỗ phục sinh=sống lại tại chỗ
khắc chế thủ đoạn=thủ đoạn khắc chế
duy nhất hạn chế=hạn chế duy nhất
hắn cấp độ=cấp độ của hắn
thể nội bất hủ máu=dòng máu bất hủ trong cơ thể
Bạch Long hồ=hồ Bạch Long
rời đi=rời khỏi
sáng tạo chi thư=Sáng Tạo Chi Thư
Dung nham chi môn=Cánh Cửa Dung Nham
nhìn xa trông rộng=Nhìn Xa Trông Rộng
trọng lực gông xiềng=Gông Xiềng Trọng Lực
yên tĩnh hào quang=Hào Quang Yên Tĩnh
xuân hi chi mưa=Mưa Xuân Hi
Nguyên tố chúa tể=Chúa Tể Nguyên Tố
bên trong phạm vi=trong phạm vi
Tuy rằng có thể=tuy có thể
Vận mệnh quấy rầy thuật=Thuật Quấy Rầy Vận Mệnh
lãnh chúa thu được=lãnh chúa nhận được
màu đen miếng sắt=miếng sắt màu đen
cảm giác không đến=không cảm giác được
mà lại tựa hồ=mà giống như
mua về sau này=sau này mua về
cũng thử qua=cũng đã thử
tinh thần lực=lực lượng tinh thần
quỷ dị ba động=ba động quỷ dị
quỷ dị đồ vật=đồ vật quỷ dị
thần bí đồ vật=đồ vật thần bí
một trận oanh minh=oanh minh một trận
thật lớn âm thanh=âm thanh thật lớn
thiên tư không đủ=không đủ thiên tư
không phải đại nghị lực người=người không có nghị lực lớn
thân thể không đủ cường đại người=người không có thân thể cường đại
lớn tiếng bật cười=cười lớn một tiếng
nhục thân công pháp không thiếu=không thiếu công pháp nhục thân
công pháp tu luyện không thiếu=không thiếu công pháp tu luyện 
vũ khí cũng không thiếu=cũng không thiếu vũ khí
tư nguyên không thiếu=không thiếu tư nguyên
rất rõ ràng nhược điểm=nhược điểm rất rõ ràng
hắn chỉ sợ=chỉ sợ hắn
đối phó linh hồn thủ đoạn=thủ đoạn đối phó linh hồn
khủng bố thủ đoạn=thủ đoạn khủng bố
công kích khủng bố thủ đoạn=thủ đoạn công kích khủng bố
Sinh mệnh dù sao=dù sao sinh mệnh
Nhưng là hiện tại=nhưng bây giờ
thần mài quan tưởng đại pháp=Thần Mài Quan Tưởng Đại Pháp
không đồng dạng=không giống
nhằm vào linh hồn thủ đoạn=thủ đoạn nhằm vào linh hồn
cái gì cảnh giới=cảnh giới gì
tuy nhiên thực lực=tuy thực lực
tuy nhiên thực lực khả năng=tuy thực lực của hắn có thể
nhưng tùy thời cũng có thể=nhưng bất cứ lúc nào cũng có thể
trong nháy mắt thì trở nên kiên định=lập tức trở nên kiên định
cái kia kinh khủng cường giả=cường giả kinh khủng kia
cực kỳ cường đại linh khí=linh khí cực kỳ cường đại
Hắn tâm tình=Tâm tình của hắn
đối với chúng ta xuất thủ=xuất thủ đối với chúng ta
cho ta an tĩnh một điểm=yên tĩnh một chút cho ta
hiện tại liền đi=lập tức đi ngay
, liền mang theo=, hắn lập tức mang theo
chính ở đây đâu=còn đang ở đây
Hắn trước kia làm sao lại=Sao trước kia hắn lại
heo đồng đội=đồng đội ngu như heo
Sinh mệnh khí tức=Khí tức sinh mệnh
Thành Chủ phủ=phủ Thành Chủ
Thanh Dã hoang nguyên=hoang nguyên Thanh Dã
cường đại khí tức=khí tức cường đại
Ngay tại hai người=ngay khi hai người
một mặt hòa khí=lộ ra vẻ mặt hòa khí
thì càng thêm hơn=lại càng lớn hơn
cấu kết đến cùng nhau=cấu kết với nhau
Hắn chẳng lẽ=chẳng lẽ hắn
còn muốn bằng vào một người=lại muốn dựa vào một người
ba người vẻ mặt=vẻ mặt ba người
biết được sau khi=sau khi biết được
vào không được=không vào được
ngài sao lại=sao ngài lại
Hắn ánh mắt=ánh mắt hắn
nhìn như vậy đến=như vậy xem ra
trước mắt vị lão giả=vị lão giả trước mắt
chân chính thiên kiêu=thiên kiêu chân chính
bọn họ mỗi một=mỗi một người bọn họ
Đại Càn vương thất=Vương thất Đại Càng
đỉnh cấp tông môn=tông môn đỉnh cấp
chúng ta kia bây giờ=vậy bây giờ chúng ta
v.v=vân vân
yêu cầu giải khóa=yêu cầu mở khóa
trí tuệ kết tinh=kết tinh trí tuệ
lên kệ=đăng bán
số lượng trước mắt=số lượng hiện tại
Sunvine ẩn sĩ=Ẩn Sĩ Sunvine
Tự nhiên chi hồn=Hồn Tự Nhiên
mãnh liệt sinh trưởng=Sinh Trưởng Mãnh Liệt
phì nhiêu lục quang=Lục Quang Phì Nhiêu
huyết tinh thả=Huyết Tinh Thảo
thần cấm chi tường=Tường Thần Cấm
tử mẫu phù thuẫn=Tử Mẫu Phù Thuẫn
Tử mẫu phù thuẫn=Tử Mẫu Phù Thuẫn
Uy lực nhìn qua=xem ra uy lực
còn giống như không sai=cũng coi như không tệ
chính về hướng=đang hướng về
Đại sư cấp=cấp Đại Sư
Cung nỏ loại vũ khí=vũ khí loại cung nỏ
Ma văn cấu trang sư=Cấu Trang Ma Văn sư
cấp thần rèn đúc sư=thợ rèn cấp Thần
từ phù xoắn ốc=Từ Phù Xoắn Ốc
tiền thưởng khu=khu tiền thưởng
tham khảo tư liệu=tư liệu tham khảo
Từ phù xoắn ốc xe bắn tên=xe bắn tên Từ Phù Xoắn Ốc
mục tiêu phòng ngự=phòng ngự của mục tiêu
Phóng ra thời điểm=lúc phóng ra
từ phù thiết=Từ Phù Thiết
nổ tung trung tâm=trung tâm nổ tung
thu nhận giá trị=giá trị thu nhận
ngươi thu được=ngài nhận được
cấp ba lãnh địa=lãnh địa cấp ba
kinh người sức chiến đấu=sức chiến đấu kinh người
Chúng nó hiện tại=hiện tại chúng nó
Sau đó một màn=Một màn sau đó
, nhường những= đã khiến những
chân chính quái vật=quái vật chân chính
tự lành tốc độ=tốc độ tự lành
dưới trướng dũng sĩ=dũng sĩ dưới trướng
mười mấy vạn=mấy trăm ngàn
mấy vạn=mười mấy ngàn
tổ tiên đồ đằng=Đồ Đằng Tổ Tiên
Cái nào lựa chọn=Lựa chọn nào
[ có hay không chiếm lĩnh!=[ Có chiếm lĩnh hay không?
lãnh chúa quyền hành=quyền hành lãnh chúa
khoáng sản tài nguyên=tài nguyên khoáng sản
cấp bốn lãnh địa=lãnh địa cấp bốn
nội thành diện tích=diện tích nội thành
thứ hai lãnh địa=lãnh địa thứ hai
chiếm lĩnh phương thức=phương thức chiếm lĩnh
[ phân giải tiến hành bên trong=[ Đang tiến hành phân giải
hư không tan rã xạ tuyến=Xạ Tuyến Tan Rã Hư Không
bình thường chiếm lĩnh=chiếm lĩnh bình thường
hi hữu binh chủng kiến trúc=kiến trúc binh chủng Hi Hữu
nhân loại lãnh chúa=lãnh chúa nhân loại
thủy tinh truyền tấn=Thủy Tinh Truyền Tấn
Các dũng sĩ trạng thái=Trạng thái của các dũng sĩ
Chiểu Ếch Nhân=Chiểu Ếch Nhân
Yên Tĩnh Quang Hoàn=Quang Hoàn Yên Tĩnh
Linh Hồn Chi Thủ=Thủ Đoạn Linh Hồn
Tý Dịch Nhân=Người Kỳ Nhông
ma dược chế tác phân xưởng=Phân xưởng chế tạo Ma Dược
hiệu suất sinh sản=hiệu suất sản xuất
Hi Hữu=Hiếm Có
hi hữu=Hiếm Có
Dược tề=thuốc
thú triều=thủy triều quái thú hoang dã
dã thú=quái thú hoang dã
cấm vệ Ngự Lâm doanh=Doanh trại Cấm vệ Ngự Lâm 
Thần cấm chi tường= tường Thần Cấm
ma văn phụ thể sư=Phụ Thể Ma Văn Sư
Ma văn cấu trang=Cấu Trang Ma Văn
Cự Long Chi Dực=Cánh Cự Long
dung nham chi môn=Cánh Cửa Dung Nham
Cự Long Thân Thể=Thân Thể Cự Long
nguyên tố Chúa Tể=Chúa Tể Nguyên Tố
nơi này đáng lẽ=đáng lẽ nơi này
【 cảnh cáo=【 cảnh báo
máy móc âm thanh=âm thanh máy móc
một mặt mộng bức=trở nên ngơ ngác
tại hắn trước mặt triển khai=hiện ra ở trước mặt hắn
phòng ngự hộ thuẫn=hộ thuẫn phòng ngự
cường đại ý chí=ý chí cường đại
nặng nề cơ giáp=bộ giáp nặng nề
xung quanh hoàn cảnh=hoàn cảnh xung quanh
kiến trúc công trình=công trình kiến trúc
máy móc thiết bị=thiết bị máy móc
Hắc Phong kỵ sĩ=Kỵ Sĩ Hắc Phong
bắt chước ngụy trang chiến đấu không gian=không gian chiến đấu mô phỏng
Từ Phù Đĩa Ném=Đĩa Bay Từ Phù
Tổ Long Chi Lân=Vảy Tổ Long
pho tượng lãnh chúa=Pho Tượng Lãnh Chúa
lãnh chúa chi huy, phúc đến tính linh=Ánh Sáng Lãnh Chúa, Phúc Đến Tính Linh
Trước mắt hình tượng=cảnh tượng trước mắt
hắn tựa hồ=hình như hắn
Nghĩ đến cái này=Vừa nghĩ đến đây
Một phen tìm tòi=Sau khi tìm kiếm một phen
Phòng ngự hình=loại hình phòng ngự
Hợp kim răng cưa=Lưỡi Cưa Hợp Kim
Hắc giáp chiến khôi=Mũ Giáp Chiến Đấu màu đen
Hắc giáp chiến giáp=Áo Giáp Chiến Đấu màu đen
Hắc giáp cánh tay máy=Giáp Tay Chiến Đấu màu đen
Hắc giáp máy móc chi=Giáp Chân Chiến Đấu màu đen
Bên ngoài thiết trang bị 1=trang thiết bị bên ngoài số 1
Lôi đình phong bạo thuẫn=Lá Chắn Bão Sấm Sét
Nhập môn hình phòng ngự cơ giáp=người máy loại hình phòng ngự cơ bản
hắc giáp thú=thú Hắc Giáp
điều khiển độ khó=độ khó điều khiển
【 cơ giáp năng lực giá trị=【 thông số năng lực người máy
Năng lượng giá trị=giá trị năng lượng
Chiến kỹ=kỹ năng chiến đấu
Liền các hạng tính năng=ngay cả các tính năng
hình tròn bảng=bảng hình tròn
Sinh vật cơ giáp=người máy sinh học
cấp cao trí năng=trí năng cấp cao
vậy mà liền loại=ngay cả loại
tinh vòng=hệ vành đai hành tinh
Đế Nhẫn Tinh=hệ vành đai hành tinh
tinh vòng=Hệ Vành Đai Hành Tinh
Sinh vật cơ giáp=Người Máy Sinh Học
hủ hóa sinh vật=sinh vật biến dị
【 thu hoạch điều kiện=【 điều kiện thu hoạch
cao cấp nhất chiến lực=chiến lực cao cấp nhất
điều khiển giao diện=giao diện điều khiển
máy móc linh kiện=linh kiện máy móc
Dyson vòng=Quả cầu Dyson
Tinh vòng Liên Bang=Liên Bang Hệ Vành Đai Hành Tinh
Tinh Vòng Liên Bang=Liên Bang Hệ Vành Đai Hành Tinh
mặt đất hoàn cảnh=hoàn cảnh mặt đất
Hủ hóa khu vực=khu vực biến dị
tinh nhuệ bộ đội cơ giáp=đôi quân Người Máy tinh nhuệ
thành thị bên ngoài=bên ngoài thành thị
liền bên ngoài cũng không tính=còn không được tính là bên ngoài
gian phòng bên trong=trong phòng
tin tức giao diện=bảng thông tin
tại hắn trước mặt bắn ra=xuất hiện ở trước mắt hắn
Tầng dưới công dân=công dân tầng dưới
đồng liên bang=đồng Liên Bang
cá nhân hắn tin tức=thông tin cá nhân của hắn
tinh vòng Liên Bang mạng lưới=mạng lưới Liên Bang Tinh Hoa
tinh Vòng Liên Bang mạng lưới=mạng lưới Liên Bang Tinh Hoa
mạng lưới chức năng=chức năng mạng lưới
D78 khu=khu vực D78
tầng dưới công dân=công dân tầng dưới
khoang điều khiển bên trong=trong khoang điều khiển
thần kinh nguyên nhận lấy=kết nối thần kinh
Vương giai=cấp Vương
Lãnh chúa chi huy=Ánh Sáng Lãnh Chúa
phúc chí tính linh=Phúc Đến Tính Linh
Triệu Hoán Hệ=hệ Triệu Hoán
Có lời nói thật tốt nói=có gì từ từ nói
cùng lúc trước so sánh,=nếu so với lúc trước thì
đối hai người dặn dò=dặn dò hai đồ đệ của mình
ai cũng không thể=không ai có thể
cái gì át chủ bài=át chủ bài gì
bài xích lực=lực bài xích
bão từ găng tay=găng tay Bão Từ
Từ Phù Thiết=thiết Từ Phù
năng lượng kết tinh=kết tinh năng lượng
trường lực=lực từ trường
người làm phép=pháp thuật sư
Ma Văn Cấu Trang=Cấu Trang Ma Văn
nước năng lượng nguyên tố vòng xoáy=vòng xoáy năng lượng nguyên tố nước
nguyên tố vòng xoáy=vòng xoáy nguyên tố
năng lực bảo mệnh=năng lực bảo vệ mạng sống
Thương Lam lãnh địa=lãnh địa Thương Lam
Quang năng thủy tinh=quả cầu ánh sáng thủy tinh
nguyên tố vòng xoáy=vòng xoáy nguyên tố
năng lực bảo mệnh=năng lực bảo vệ mạng sống
Hoàn Vũ viện nghiên cứu Ma Văn=viện nghiên cứu Ma Văn Hoàn Vũ
Thương Lam lãnh địa=lãnh địa Thương Lam
Quang năng thủy tinh=quả cầu ánh sáng thủy tinh
Hắc Diệu Thạch=đá Hắc Diệu
Âm Ảnh Chi Quốc=quốc gia Âm Ảnh
Bạch Giáp Trư Thú Chi Bạch Giáp=Bộ giáp Bạch Giáp Trư Thú
liên minh chi chứng=Chứng Chỉ Liên Minh
Pháp thuật lưu phái 1=Pháp thuật hệ 1
ảo thuật=pháp thuật
lưu phái=hệ
Quang Minh Giáo Hội=giáo hội Quang Minh
khiếp sợ không thôi=cực kỳ khiếp sợ
nguyên tố hệ=hệ Nguyên Tố
áo thuật chi thần=pháp thuật sư cấp Thần
nồng nặc nguyên tố=nguyên tố nồng nặc
Pháp thuật nghẹt thở=pháp thuật vô hiệu
nguyên tố hệ pháp thuật=pháp thuật hệ Nguyên Tố
nguyên tố pháp thuật sư=pháp thuật sư hệ Nguyên Tố
Phong trung hành giả=Phong Trung Hành Giả
Miêu nhân=Người Mèo
bán thú nhân=Nửa Người Thú
hổ nhân tộc=tộc Người Hổ
hổ nhân=Người Hổ
Miêu nhân tộc=tộc Người Mèo
Miêu tộc=tộc Người Mèo
lãnh chúa chi chứng=chứng chỉ lãnh chúa
Bán thú nhân=Nửa Người Thú
Địa Tâm Thạch=đá Địa Tâm
vong linh=Vong Linh
Mây Không Thạch=đá Mây Không
Huyền bí chi quan=Huyền Bí Chi Quan
nền tảng giao dịch=sàn giao dịch
Nguyên tố Chúa Tể=Chúa Tể Nguyên Tố
tại thì phải làm thế nào đây=ở đây thì sao nào
ta giết định các ngươi=ta nhất định phải giết hết các ngươi
lạnh lẽo thấu xương âm thanh=giọng nói lạnh thấu xương
Cái này vừa nói=Vừa nghe thấy hắn nói câu này
hoang nguyên phía trên=ở trên hoang nguyên
là có bao nhiêu phách lối,=phải phách lối cỡ nào 
mới có thể nói ra như vậy=mới có thể nói ra những lời như vậy được chứ?
nhưng tại chỗ cũng=nhưng ở đây cũng
không so ngươi yếu=không yếu hơn ngươi rồi
Có thể theo=nhưng sau khi
lão thiết trên đầu người khí tức kéo lên=khí tức tỏa ra trên người lão thiết đầu dần tăng lên
cũng là biến đổi=cũng dần trở nên khó coi hơn
Từng đạo từng đạo không dám tin âm thanh=liên tục là những câu hỏi thể hiện rõ sự không dám tin
cũng biến thành ngưng trọng lên=cũng trở nên rất nghiêm trọng
xem ra chúng ta muốn liên thủ=xem ra hôm nay chúng ta phải liên thủ với nhau rồi
muốn hay không ra tay giúp đỡ?=có nên ra tay hỗ trợ hay không?
lên tiếng hỏi=đột nhiên hỏi
Trước chờ một chút=tạm thời chưa cần, chúng ta chờ xem một chút đã
giữa không trung lão thiết đầu=lão thiết đầu đang ở giữa không trung
Một đạo chưởng ấn lần nữa về hướng=lại là một đạo chưởng ấn khác bị đánh ra
phụ cận một chiếc linh chu vỗ tới=đánh thẳng về phía một chiếc linh chu gần nhất
cái này nếu như hắn không xuất thủ=nếu như bây giờ hắn vẫn không ra tay
cái kia phụ thuộc môn phái=môn phái phụ thuộc kia
đồng loạt ra tay=chúng ta cùng nhau ra tay
Theo một tiếng vang thật lớn=một tiếng nổ vang thật lớn
, ta liền thành toàn các ngươi= thì ta sẽ thành toàn cho các ngươi
băng lãnh âm thanh phun ra=cực kỳ tức giận nói ra một câu
sau đó khẽ quát một tiếng=sau đó hắn quát khẽ một tiếng
thân thể trong nháy mắt=cơ thể lập tức
một chưởng về hướng lồng ngực của hắn vỗ tới=đánh ra một chưởng về hướng lồng ngực của hắn
đồng dạng oanh ra một quyền=hắn cũng đánh trả lại một quyền
trong không khí dẫn phát=làm cho không khí phát ra
vẻn vẹn chỉ là=chỉ có thể
, liền bị= đã bị
thậm chí khóe miệng đều=thậm chí ngay cả trên khóe miệng của hắn
mang một vệt máu=cũng chảy ra một vết máu
Hắn vẻ mặt ngưng trọng=vẻ mặt của hắn cực kỳ ngưng trọng
đồng loạt ra tay=cùng nhau ra tay
phi thân mà ra=phi người bay lên trước
kịch liệt tranh đấu=tranh đấu kịch liệt
đạo thân ảnh=bóng người
kịch liệt giao đánh nhau=đánh nhau kịch liệt
Kinh khủng uy áp=uy áp kinh khủng
về hướng xung quanh tràn ngập=lan rộng ra xung quanh
oanh ra cái này đến khác cái hố=nổ ra mấy cái hố vừa sâu vừa rộng
Muốn là ta có bực này tu vi,=nếu như ta có tu vi cỡ này thì
cái này uy áp=lực uy áp này
Theo một tiếng nổ ầm ầm=đột nhiên một tiếng nổ ầm vang lên
chúng ta muốn xuất thủ sao?=chúng ta có nên ra tay không?
Hiện tại chính là=bây giờ chính là
xuất thủ cơ hội tốt=cơ hội tốt nhất để ra tay
nếu là lần này=nếu như lần này
hắn coi như=cho dù hắn
ta tới giúp ngươi=để ta tới giúp ngươi
chả lẽ lại sợ ngươi=chả lẽ ta lại sợ ngươi
màu đỏ thắm chiến đao=chiến đao màu đỏ thắm
cường đại uy áp=uy áp cường đại
Có thể lúc này thời điểm=nhưng lúc này
hắn tình thế có thể nghĩ=có thể thấy được tình thế của hắn khổ sở đến cỡ nào
Tốt, ta đồng ý=Được, ta đồng ý
không có chút nào áy náy=không có chút áy náy nào
không thể nào sự tình=chuyện không thể nào xảy ra
An gia lão giả=lão giả An gia
một ngụm máu tươi phun ra=phun ra một ngụm máu tươi
ngay tại lúc này=đúng vào lúc này
Đại địa đang run rẩy=mặt đất không ngừng chấn động
xuy xuy nổ vang=tiếng nổ xuy xuy
khí lãng về hướng xung quanh khuếch tán=khí lãng mở rộng ra xung quanh
thì sau đó một khắc=chỉ một khắc sau
thần bí lão đầu=lão đầu thần bí
cuồng bạo một màn=một màn cuồng bạo
có động tác gì=kịp làm gì
chuyện gì xảy ra=đã xảy ra chuyện gì vậy
Dạng gì cường giả=phải là cường giả gì
làm được điểm này=làm được chuyện như vậy chứ
Ai cũng không biết=không ai biết được
hay không chân chính rời khỏi=đã chân chính rời khỏi đây hay chưa
xác thực rất mạnh=đúng là rất mạnh
khí vận chi lực=lực lượng khí vận
đào mệnh=chạy trốn giữ mạng
nhưng mà cái này=nhưng mà đây vẫn
ngươi sẽ không ở gạt ta a?=không phải ngươi lừa ta đó chứ?
muốn là như vậy=nếu thật sự là như vậy
còn thế nào đánh?=còn đánh gì được nữa?
tinh hồng ánh mắt=hai mắt đỏ như máu của nó
trước mắt hình tượng=cảnh tượng trước mắt
【 mục tiêu tên=【 Tên mục tiêu
【 mục tiêu cấp độ=【 Cấp độ mục tiêu
【 mục tiêu loại hình=【 Loại hình mục tiêu
【 sinh mệnh lực=【 Điểm sinh mệnh
【 nguy hiểm hệ số=【 Hệ số nguy hiểm
【 tin tức=【 Thông tin
cẩn thận ứng đối=phải đối phó cẩn thận
bọn hắn trong miệng nói=mà bọn hắn nói tới à
duy nhất ưu thế=ưu thế duy nhất
Làm sao bây giờ?=bây giờ ta phải làm sao đây?
Đối kháng chính diện lời nói,=nếu đối kháng chính diện thì
cùng quái vật chiến đấu=chiến đấu với quái vật
cân nhắc thời cơ=cơ hội suy nghĩ
Phát hiện sau này hắn=sau khi phát hiện ra hắn
hướng hắn bạo trùng tới=lao nhanh về phía hắn
Nhìn đến chỉ có thể kiên trì lên=xem ra ta chỉ có thể cố gắng cầm cự thôi
nghênh chiến tư thái=tư thái nghênh chiến
tinh chuẩn đâm vào=đâm chuẩn xác vào
nó phần gáy bên trong=sau gáy của nó
một kích này uy lực=uy lực do một kích này đánh ra
so với hắn tưởng tượng=trong tưởng tượng của hắn
May mắn bết bát nhất tình huống=may mà tình huống xấu nhất
chưa từng xuất hiện=vẫn chưa xuất hiện
máy móc đội ngũ=đội ngũ người máy
thành khu phương hướng=phương hướng thành trì
cấp tốc chạy đến=nhanh chóng chạy đến
bộ đội cơ giáp=quân đoàn người máy
Chiến Đấu Cơ Giáp=người máy chiến đấu
bá khí vô cùng=vô cùng bá khí
Thiên Không kỵ sĩ đoàn=đoàn kỵ sĩ Thiên Không
thứ bảy bộ đội cơ giáp=quân đoàn người máy thứ bảy
tại đội ngũ trung ương nhất=ở chính giữa nhất của đội ngũ
không trung lơ lửng=lơ lửng trên bầu trời
thanh danh tại ngoại=thanh danh vang xa
vừa rồi đối phương biểu hiện=biểu hiện vừa rồi của đối phương
đến xem,=xem ra hắn
Đội Sky Knights=đoàn kỵ sĩ Thiên Không
thú hang động=Địa Huyệt Thú
Thánh linh tủy dịch=dung dịch Thánh Linh Tủy
Thần chi khóa=Ổ Khóa Thần
tín ngưỡng chi lực=lực lượng tín ngưỡng
không gian giới chỉ=nhẫn không gian
Amazon các nữ chiến sĩ=các nữ chiến sĩ Amazon
Hồng Nguyệt=Trăng Máu
truy tố chi kính=Gương Theo Dõi
Long Tiên Thạch=đá Long Tiên
truyền thừa chi thạch=đá Truyền Thừa
Áo thuật sư=pháp thuật sư
nguyên tố pháp thuật tháp=tháp pháp thuật hệ Nguyên Tố
đại áo thuật sư=pháp thuật sư cấp Đại Sư
truyền kỳ áo thuật sư=pháp thuật sư cấp Truyền Kỳ
Tin tức nhắc nhở=thông báo
thu được kinh nghiệm=nhận được kinh nghiệm
Annie công chúa=công chúa Annie
thu được tin tức=đã nhận được thông báo
anh linh hồn ấn=Hồn Ấn Anh Linh
anh linh đơn vị=đơn vị Anh Linh
tin nhắn hồi phục=tin nhắn trả lời
công tác này=công việc này
chợt đại biến=lập tức thay đổi
thần sắc nghiêm túc=vẻ mặt nghiêm túc
thần sắc hồi ức=vẻ nhớ lại
địa vị tối cao=địa vị cao nhất
một tòa núi=một ngọn núi
thân ảnh cao lớn=bóng người cao lớn
, cái kia có=, vậy thì có
suy tư một chút=suy nghĩ một chút
dạng này công pháp=công pháp như thế này
Nhìn lấy các đồ đệ ánh mắt sùng bái kia=nhìn ánh mắt sùng bái của các đồ đệ
dạng gì cơ duyên=cơ duyên gì
thần khí cấp bậc=cấp bậc Thần khí
Đại Đế chi mộ=mộ của một Đại Đế
Thánh Nhân chi mộ=mộ của một Thánh Nhân
hắn khẳng định=chắc chắn hắn đã
thu được truyền thừa cùng bảo vật=nhận được truyền thừa và bảo vật
truyền thừa cùng bảo vật=truyền thừa và bảo vật
thu được truyền thừa=nhận được truyền thừa
thu được bảo vật=nhận được bảo vật
cường giả thần hồn=thần hồn cường giả
đều chẳng có gì lạ=cũng không có gì bất ngờ
loại này khí vận chi tử=loại khí vận chi tử này
vậy dạng này nói=nếu nói như vậy
so khí vận chi tử cao=cao hơn khí vận chi tử
mấy cái đại cảnh giới=mấy đại cảnh giới
mấy đồ đệ ánh mắt=ánh mắt mấy đồ đệ
sáng không ít=sáng hơn không ít
nhẹ nhàng gật đầu=nhẹ gật đầu
Nhưng loại tình huống này=nhưng loại chuyện này
cần phải rất khó sẽ xảy ra=thường sẽ rất khó xảy ra
liền đem khí vận chi tử giết chết=giết chết khí vận chi tử
rất có khó khăn=rất là khó khăn
trên người át chủ bài=át chủ bài trên người
Nhưng mà vẫn là phải cho=nhưng hắn vẫn phải cho
thiên kiêu cấp bậc=cấp bậc thiên kiêu
cùng thế hệ bên trong=trong cùng thế hệ
hắn mấy đồ đệ sau này=sau này mấy đồ đệ của hắn
đan dược vô số=vô số đan dược
tu vi so với bọn hắn thấp khí vận chi tử=khí vận chi tử tu vi thấp hơn bọn hắn
vẫn là không có vấn đề=vẫn không có vấn đề gì
như thế ngang tàng=ngang tàng như thế
thánh khí=Thánh khí
thần khí=Thần khí
đem ánh mắt nhìn về phía=dời ánh mắt về phía
do dự thần sắc=vẻ do dự
sư tôn lời này=lời này của sư tôn
thần sắc kích động=vẻ kích động
trong nhà tiểu muội=tiểu muội trong nhà
chỉnh thể thực lực=thực lực chỉnh thể
gia tộc trụ sở=trụ sở gia tộc
làm vì một đại gia tộc=là một đại gia tộc
cũng là rất nhiều=cũng rất nhiều
nô bộc cùng cung phụng=nô bộc và cung phụng
ngay tại trò chuyện=đang trò chuyện
với nhau thứ gì=gì đó với nhau
phụ nhân âm thanh=âm thanh của phụ nhân
Thần Thánh giáo hội=giáo hội Thần Thánh
Chân Lý giáo hội=giáo hội Chân Lý
Tự Nhiên giáo hội=giáo hội Tự Nhiên
Tự Nhiên Thần điện=Thần điện Tự Nhiên
Tự Nhiên nữ thần=Nữ thần Tự Nhiên
thần Thánh giáo đường=giáo đường Thần Thánh
tín ngưỡng người=người tín ngưỡng
chân chính liên minh=liên minh chân chính
ở kênh thế giới bên trong=ở bên trong kênh Thế Giới
người phụng tín=tín đồ
Biển thần lãnh chúa=lãnh chúa Hải Thần
lãnh chúa nhân loại=lãnh chúa Nhân Loại
Thạch giác thú=thú Thạch Gíac
Túc Khinh Đội binh doanh=binh doanh đội quân Túc Khinh
tự tìm phiền phức=tìm phiền phức cho mình
Tháp phòng ngự=tháp Phòng Ngự
, liền khiến= đã khiến
Bao khỏa thần bí=túi quà bí mật
Bao khỏa Thần bí=túi quà bí mật
Thiên sứ=Thiên Sứ
Phúc âm cứu rỗi=Phúc Âm Cứu Rỗi
Cứu rỗi phúc âm=Phúc Âm Cứu Rỗi
, liền nhìn thấy=, hắn lập tức nhìn thấy
liền nhìn thấy=đã lập tức nhìn thấy
cảnh tượng khiến cho=cảnh tượng làm cho
thì giống như là=giống như là
khối màn che=tấm màn
phảng phất giống như=giống như
lẻn lui ra phía sau=lén lút lui ra sau lưng
bất cứ lúc nào cũng có thể trốn đi=chạy trốn bất cứ lúc nào
mười không đủ một=không đến một phần mười
chen chúc mà ra=chen chúc lao ra
nhằm về phía=đánh thẳng về phía
vẻ mặt trắng bệch,=vẻ mặt của hắn trở nên trắng bệch,
lãnh chúa đỉnh cấp=lãnh chúa đứng đầu
cùng nó phí lời=phí lời với nó
Chân Lý Của Thần=Thần Chân Lý
cất cao thân thể=cơ thể của hắn bay lên cao
thành ma tháp=thành Ma Tháp
xạ tuyến tan rã hư không=Xạ Tuyến Tan Rã Hư Không
thánh quang phán quyết=Thánh Quang Phán Quyết
thiên sứ=Thiên Sứ
Vào thời điểm này=nhưng vào lúc này
kịch liệt rung động=rung động kịch liệt
Xé rách người=Tê Liệt Giả
Lin đêm=Lâm Dạ
Hiệp sĩ kiếm đen=Kỵ sĩ Hắc Phong
người tín ngưỡng=Tín Đồ
hồn hỏa=ngọn lửa linh hồn
thánh quân=Thánh Quân
thần long=Thần Long
Lam tinh=Lam Tinh
cũng cấp tốc=cũng nhanh chóng
Thân thể bất hủ=Thân Thể Bất Hủ
máu bất hủ=dòng máu Bất Hủ
Điều Đình Như Ý=Điều Đình Như Ý
Thời không chi lực=Lực Lượng Thời Không
thời gian bất động=thời gian dừng lại
lực lượng tín ngưỡng=Lực Lượng Tín Ngưỡng
bạo liệt ma hoàn=Ma Hoàn Bạo Liệt
u ma khải giáp=Khải Giáp U Ma
quang năng thủy tinh=Thủy Tinh Quang Năng
cấm ma chi vực=Linh Vực Cấm Ma
tinh hồng chi trăng=Trăng Máu
Hoàng Vũ thành=thành Hoàn Vũ
linh tịch thạch=đá Linh Tịch
lãnh địa Hoàng Vũ=lãnh địa Hoàn Vũ
cửa hàng Hoàng Vũ=cửa hàng Hoàn Vũ
Hồng nguyệt=Trăng Máu
Hoàng Vũ lãnh địa=lãnh địa Hoàn Vũ
thánh võ sĩ=Thánh Võ Sĩ
Một tiếng vang thật lớn=một tiếng nổ thật lớn vang lên
nhưng không có liếc hắn một cái=lại không thèm liếc nhìn hắn một cái
binh doanh kiến trúc=kiến trúc binh doanh
một toà quặng sắt=một quặng sắt
Ngươi nói là sự thật?=ngươi nói thật chứ?
cũng là chấn động=cũng chấn động
thanh âm đều lớn thêm=giọng nói của hắn lại lớn hơn
Quản gia bộ dáng lão giả=lão quản gia
trong mắt càng là=trong mắt hắn càng
Đợi thoáng bình phục một chút tâm tình kích động=sau khi cảm xúc kích động trong lòng hơi lắng lại
đối với quản gia phân phó nói=mới bắt đầu phân phó cho quản gia
liền nói ta=cứ nói là ta
chuyện quan trọng thương lượng=chuyện quan trọng cần thương lượng
đều tại hưng phấn run rẩy=đều hưng phấn đến run rẩy
là xảy ra chuyện gì sao?=đã xảy ra chuyện gì vậy?
liền có thể=sẽ có thể
Thật?=Ngươi nói thật chứ?
Ngươi không phải là gạt ta?=Ngươi không phải đang lừa ta đúng không?
Ngươi không phải là gạt ta a?=Ngươi không phải đang lừa ta đúng không?
Ta lừa gạt ngươi làm gì=ta lừa ngươi làm gì
đem hắn mang về=đưa hắn trở về
trùng điệp gật đầu một cái=gật đầu thật mạnh một cái
bọn họ đợi thời gian rất lâu=bọn họ đã đợi rất lâu rồi
đối chính hắn=đối với bản thân hắn
Lúc trước nếu không phải=nếu không phải lúc trước
chỗ lấy để cho các ngươi tới=gọi các ngươi tới đây
cái này chỉ sợ=chỉ sợ chuyện này
chiếu cố=chăm sóc
không quan hệ=không liên quan
có ý tứ=thú vị
vạn nhất=lỡ như
cái này thế lực=thế lực này
bọn hắn tại sao=tại sao bọn hắn
Nhưng bọn hắn tại sao không có=nhưng tại sao bọn hắn lại không
bọn họ là chết như thế nào=bọn họ đã chết thế nào
cũng đi tới một đoàn người=có một đám người đi tới
hai cái chữ to=hai chữ to
trong mắt lộ ra=trong mắt của hắn lộ ra
một tia nhớ lại thần sắc=một vẻ hồi ức
làm vì gia tộc đệ nhất đệ tử thiên tài=chính là đệ tử thiên tài đệ nhất của gia tộc
đời tiếp theo gia chủ=gia chủ đời tiếp theo
đời tiếp theo gia chủ chi vị=cái ghế gia chủ đời tiếp theo
Có thể cái nào nghĩ đến=nhưng ai có thể ngờ được
làm sao tính được số trời=người tính lại không bằng trời tính
Hết thảy đều đã đi qua=mọi chuyện đều đã qua rồi
ta cuối cùng rồi sẽ có càng xa=cuối cùng rồi cũng sẽ có ngày ta đi càng xa
khí thế trên người cũng=khí thế trên người hắn cũng
biến thành càng thêm sắc bén lên=trở nên càng sắc bén hơn
Nói xong, liền sải bước=Nói xong, hắn sải bước
về hướng trang viên cửa chính đi đến=đi về hướng cửa chính của trang viên
Lời này làm sao cảm giác=Sao hắn lại cảm thấy lời này
như thế quen tai đâu=nghe quen tai như vậy nhỉ
cái kia nhận được kỳ ngộ khí vận chi tử=khí vận chi tử nhận được kỳ ngộ kia
Ta rốt cục về đến rồi=cuối cùng ta đã trở về rồi
cái này nhị đồ đệ=nhị đồ đệ này
chính mình cái này nhị đồ đệ=nhị đồ đệ này của mình
Mắt thấy có người=nhìn thấy có người
về hướng trang viên đi đến=đi về hướng trang viên
canh giữ ở cửa chính hai người=hai người canh gác ở cửa chính
trên mặt càng là mang theo=trên mặt hắn lại còn mang theo
ung dung biểu lộ=vẻ mặt ung dung
thật lâu chưa có trở về=rất lâu rồi chưa trở về
nơi này đại thiếu gia=đại thiếu gia nơi này
đánh giá trước mắt mấy người=đánh giá mấy người trước mắt
chính mình cửa chính=cửa chính nhà mình
từ một bên vang lên=từ bên cạnh vang lên
các ngươi tại cái này chờ một lát=vậy thì các ngươi chờ ta một lát
ta cái này đi vào thông báo=ta sẽ đi vào trong thông báo ngay
hắn thì về hướng trong trang viên chạy tới=hắn lập tức chạy về hướng trong trang viên
Danh tự làm sao có chút quen tai=sao cái tên này nghe quen tai như vậy chứ
Danh tự làm sao=sao cái tên này
có chút quen tai=nghe quen tai như vậy chứ
giống là nhớ ra cái gì đó=giống như nhớ ra cái gì đó
bước tiến của hắn thì nhanh hơn=bước chân của hắn lại càng nhanh hơn
thì theo cửa chính chỗ vọt ra=đã từ trong cửa chính vọt ra
Lin Night=Lâm Dạ
Cơ giáp học viện=học viện Người Máy
thật dài tin nhắn=tin nhắn thật dài
gen thiên phú=thiên phú gen
Tuyệt không phải=tuyệt đối không phải
mặt đất tầng dưới chót công dân=công dân tầng dưới chót ở mặt đất
cái này cùng mình không có bao nhiêu quan hệ=chuyện này cũng không có liên quan gì với mình
, chỉ bất quá đơn thuần=, hắn chỉ đơn thuần là
cái gì phát hiện=phát hiện gì
quan chiến kênh=kênh quan chiến
xin hỏi phải chăng thanh toán?=xin hỏi ngài có muốn thanh toán không?
Liên Bang trí não=AI Liên Bang
ngay tại vì ngài=đang giúp ngài
hình chiếu 3D hình thức=hình thức hình chiếu 3D
Hình tượng hoán đổi=cảnh tượng thay đổi
Tại một mảnh số lượng ánh sáng qua đi=Sau một cảnh trắng xóa
bắt chước ngụy trang không gian=không gian mô phỏng
Nhanh nhanh nhanh=Nhanh lên, nhanh lên
mau chóng tới nhìn xem=nhanh vào đó xem thử
Ở đâu cái chiến trường=Chiến trường ở đâu vậy
số 9 chiến trường=chiến trường số 9
vứt bỏ chi đô=Thành Phố Bỏ Hoang
Đại sảnh đám người=Đám người ở đại sảnh
màn sáng bên trong=bên trong màn sáng
ầm ầm tiếng vang=tiếng vang ầm ầm
bầu trời bên trong=trên bầu trời
càng là có=còn có
lực lượng hình cơ giáp=người máy lực lượng
cái này người=người này
kinh ngạc biểu lộ=vẻ mặt kinh ngạc
là cấp bậc gì hủ hóa sinh vật=là sinh vật biến dị cấp bậc gì
hắn trước đó đụng phải=hắn gặp phải trước đó
đối trận chiến đấu này mong đợi=mong đợi đối với trận chiến đấu này
trôi chảy động tác=động tác trôi chảy
tinh chuẩn điều khiển=điều khiển tinh chuẩn
tại hắn trước mặt=ở trước mặt hắn
thô to cánh tay=cánh tay thô to
ngăn tại thân trước=chặn ở trước người
Người máy cánh tay=Cánh tay người máy
tinh chuẩn bắt lấy=chuẩn sát bắt lấy
hung hăng chấn một=cũng run nhẹ một cái
bên trên kiến trúc=kiến trúc gần đó
nhanh nhẹn hình cơ giáp=người máy loại nhanh nhẹn
vẻn vẹn một kích=chỉ một kích
nghiêm trọng tổn hại=hư hỏng nghiêm trọng
học viên biểu lộ=vẻ mặt của học viên đó
đinh tai nhức óc tiếng vang=một tiếng nổ đinh tai nhức óc
cực đại nắm đấm=nắm đấm cực đại
hình rắn cơ giáp=người máy hình rắn
Nhắc nhở rơi xuống trong nháy mắt=ngay khi âm thanh thông báo vừa vang lên
vừa mới chiến đấu mặc dù=mặc dù trận chiến đấu vừa rồi
coi như không tệ=cũng không tệ lắm
Để hắn ngưng trọng=chuyện làm hắn ngưng trọng
sinh vật cơ giáp bản thân=bản thân người máy sinh học
Cứ việc chỉ là ngắn ngủi nửa phút chiến đấu=tuy trận chiến chỉ diễn ra trong nửa phút ngắn ngủi
cơ giáp tính năng=tính năng người máy
chính diện đối đầu=đối đầu chính diện
chính diện đối đầu lời nói=đối đầu chính diện thì
lấy không đến bất luận cái gì chỗ tốt=hắn không lấy được chút lợi thế nào
Hắn ưu thế duy nhất=ưu thế duy nhất của hắn
cảm giác cường hóa=cường hóa cảm giác
Tại tuyệt đối lực lượng trước mặt=ở trước mặt sức mạnh tuyệt đối
lại hoa lệ kỹ xảo=cho dù kỹ xảo có hoa lệ đến đâu
đều chỉ là phí công=thì cũng là vô ích
Còn tốt cố ý=may mà mình đã
bắt chước ngụy trang=mô phỏng
xác thực=đúng là
xác thực so với hắn tưởng tượng bên trong mạnh hơn rất nhiều=đúng là mạnh hơn trong tưởng tượng của hắn rất nhiều
hắn tưởng tượng bên trong=trong tưởng tượng của hắn
so với hắn tưởng tượng bên trong mạnh hơn=mạnh hơn trong tưởng tượng của hắn
không có uể oải=không nản chí
gen thức tỉnh độ tăng=tăng độ thức tỉnh gen
gen thức tỉnh=thức tỉnh gen
còn là có thể=sẽ có thể
bắt chước ngụy trang chiến trường=chiến trường mô phỏng
Nghĩ xong, liền=nghĩ đến đây, hắn lập tức
chiến đấu giao diện=giao diện chiến đấu
xứng đôi đối thủ thích hợp=tìm kiếm đối thủ thích hợp
làm không được=không làm được
Nỗ lực lên=cố gắng lên
đi không được=không đi được
ngươi nhận được=ngài nhận được
Thư Sáng tạo=Sáng Tạo Chi Thư
Pháp thuật tán loạn=Pháp Thuật Tán Loạn
chức giả Thần=Thần Chức Giả
Giáo hội Chân lý=Giáo hội Chân Lý
đều hoảng hốt lên=trở nên hốt hoảng
Thần thuật=Thần Thuật
Thiêu đốt Tín ngưỡng=Thiêu Đốt Tín Ngưỡng
tay chân luống cuống=luống cuống tay chân
Võ sĩ Thánh=Thánh Võ Sĩ
nổi giận mà gầm lên=nổi giận gầm lên
Thuật bạo bụi=Thuật Bạo Bụi
Thuật tường đất=Thuật Tường Đất
Hỗn loạn lực từ trường=Hỗn Loạn Lực Từ Trường
nháy mắt liền=nháy mắt đã
Giáo chủ=Giáo Chủ
Linh hồn chi thủ=Bàn Tay Của Linh Hồn
năng lực gien=năng lực gen
Pháp ấn Đại Hoang=Pháp Ấn Đại Hoang
Thành Thái Âm=thành Thái Âm
Thiên cung Vân Triện=Thiên Cung Vân Triện
đang nỗ lực=đang cố gắng
Phi kiếm=Phi Kiếm
chỉ là trong chốc=chỉ trong chốc
thế giới Thần thoại=thế giới Thần Thoại
Kỳ vật thế giới=Kỳ Vật Thế Giới
Hồ ly=Hồ Ly
Ấn pháp Minh Nguyệt=Ấn Pháp Minh Nguyệt
 Binh chủng= binh chủng
 Lãnh địa= lãnh địa
 Thế giới= thế giới
 Dũng sĩ= dũng sĩ
 Lãnh chúa= lãnh chúa
 Kỵ sĩ= kỵ sĩ
 Chiến sĩ= chiến sĩ
liền lướt qua=đã lướt qua
Linh lực Long Phượng=Linh Lực Long Phượng
Chư thiên vạn giới=Chư Thiên Vạn Giới
cọ một chút ánh sáng=dính ké một chút ánh sáng
Lầu Thần giáng Thái Âm=Lầu Thần Giáng Thái Âm
Nguyên Thạch Hư Không=Nguyên Thạch Hư Không
Kết tinh hư không=Kết Tinh Hư Không
Binh chủng Thần thoại=binh chủng Thần Thoại
Bán Nhân mã=Bán Nhân Mã
đơn vị Anh hùng=đơn vị Anh Hùng
Cấm vệ Ngự Lâm=Cấm Vệ Ngự Lâm
chầm chậm=chậm rãi
thanh lãnh hỏi=lạnh lùng hỏi
Chưa đâu=vẫn chưa
Tây Hoa vương quốc=vương quốc Tây Hoa
theo cửa chính xông ra=từ trong cửa chính xông ra
liền nhận ra=đã nhận ra
một chút biến hóa=thay đổi một chút
hắn tâm tình=trong lòng của hắn
là rất kích động=đang rất kích động
gia chủ cùng phu nhân=gia chủ và phu nhân
liền trở lại=đã trở lại
đến đem cái tin tức tốt này nói=phải lập tức báo tin tốt này
Trở về liền tốt=trở về là tốt rồi
ta mang ngài đi=ta dẫn ngài đi
đưa ngươi tiếp trở về đâu=đón ngài trở về đấy
không có dùng=không dùng
cái gì kình lực=kình lực gì
hắn dù sao=dù sao hắn
chính là thử=nhưng hắn thử
chẳng lẽ lại hiện tại=chẳng lẽ bây giờ lại
đại thiếu gia trên người=trên người đại thiếu gia
hắn trước đó lúc=trước đó, lúc hắn
hắn trước đó=trước đó hắn
Làm hắn lần nữa=khi hắn lần nữa
cũng rốt cục=rốt cục cũng
một điểm kỳ lạ địa phương=một chỗ kỳ lạ
ta nhà đại thiếu gia=đại thiếu gia ta nhà
về hướng trong trang viên đi đến=đi về hướng trang viên
chi thứ con cháu=con cháu chi thứ
Vừa mới người kia là=người vừa rồi là ai vậy
Hẳn không phải là=chắc là không phải đâu
vừa mới đi qua người kia=người vừa đi qua
trước kia ta nơi ở=nơi ở trước kia của ta
hài lòng liền tốt=hài lòng là tốt rồi
có chút im lặng=không biết nói gì
Mấy cái nô bộc sau khi=sau khi mấy nô bộc
bố trí khởi trận pháp=bắt đầu bố trí trận pháp
cách âm trận=trận pháp cách âm
báo động trước trận=trận pháp cảnh báo
ngăn cách lực lượng tinh thần dò xét trận pháp=trận pháp ngăn cản lực lượng tinh thần dò xét
đều là muốn bố trí=thì đều phải bố trí
cơ bản nhất phòng ngự=phòng ngự cơ bản nhất
biểu tình=vẻ mặt
vô luận=bất kể
thủy chung=từ đầu tới cuối
, liền= thì
cư nhiên=lại có thể
căn bản=vốn dĩ
bán nhân mã chiến sĩ=chiến sĩ Bán Nhân Mã
bán nhân mã=Bán Nhân Mã
thú nhân=Người Thú
binh chủng hiếm có=binh chủng Hiếm Có
nhàn nhạt cười=mỉm cười
thuộc hạ vinh hạnh=vinh hạnh của thuộc hạ
Sau đó liếc mắt=sau đó hắn liếc mắt
ta sau đó nghĩ chuyên tâm=sau này ta muốn chuyên tâm
ma văn nghiên cứu=nguyên cứu Ma Văn
lãnh địa phát triển=sự phát triển của lãnh địa
Ma văn năng lượng thuẫn=thuẫn năng lượng Ma Văn
đặc thù kiến trúc vật liệu=vật liệu kiến trúc đặc biệt
lưu ly kim=Lưu Ly Kim
Đại lục Yêu ma=Đại Lục Yêu Ma
Linh thổ Ngũ hành=Linh Thổ Ngũ Hành
Động trời Thái Âm=Động Trời Thái Âm
Thần bình tam quang=Thần Bình Tam Quang
Công xưởng Linh vật=Công Xưởng Linh Vật
bột phấn Linh căn=Bột Phấn Linh Căn
Bột phấn linh căn=Bột Phấn Linh Căn
Tiên phường Linh vật=Tiên Phường Linh Vật
thương thành Hỗn Độn=Thương Thành Hỗn Độn
vật chủng phong phú=đa dạng chủng loại
đặc thù vật liệu=vật liệu đặc biệt
khoáng sản phương diện=về mặt khoáng sản
khôn kim nham mỏ=mỏ Khôn Kim Nham
cỡ nhỏ quặng sắt=quặng sắt cỡ nhỏ
sinh sản cá biệt dược tề=chế tạo ra được loại thuốc nào
hủ sinh hoa=hoa Hủ Sinh
biệt viện bên trong trận pháp=trận pháp trong biệt viện
mấy đồ đệ bảng thông tin=bảng thông tin của mấy đồ đệ
Vương Đằng thứ hai đồ=Nhị đệ tử của Vương Đằng
Vương Đằng thứ năm đồ=Ngũ đệ tử của Vương Đằng
Vương Đằng thứ sáu đồ=Lục đệ tử của Vương Đằng
Vương Đằng thứ bảy đồ=Thất đệ tử của Vương Đằng
Vương Đằng thứ tám đồ=Bát đệ tử của Vương Đằng
Vương Đằng thứ chín đồ=Cửu đệ tử của Vương Đằng
Vương Đằng thứ mười đồ=Thập đệ tử của Vương Đằng
lễ bao đồ án=đồ án lễ bao
mặt bảng phía trên=trên mặt bảng
Khí vận giá trị=giá trị khí vận
Ma Viên quan tưởng pháp=Ma Viên Quan Tưởng Pháp
Huyền Hoàng chi khí=Huyền Hoàng Chi Khí
đặc biệt tư nguyên=tư nguyên đặc biệt
thần hồn tu luyện=tu luyện thần hồn
truyền thụ không được=không truyền thụ được
thần hồn tu luyện pháp=phương pháp tu luyện thần hồn
tại biệt viện bên trong=trong biệt viện
màu vàng vòng bảo vệ=vòng bảo vệ màu vàng
đem ta vứt=vứt ta
thì hưng phấn lên=trở nên hưng phấn
nghịch thiên cơ duyên=cơ duyên ngịch thiên
hộ thân ngọc phù=ngọc phù hộ thân
an toàn cân nhắc=cân nhắc an toàn
một đạo thanh quang=một tia sáng xanh
linh chu phía trên=phía trên linh chu
trận pháp dấu vết=dấu vết trận pháp
trước mắt sơn cốc=sơn cốc trước mắt
Trước mắt đây tất cả=tất cả những thứ trước mắt
thần bí bảo vật=bảo vật thần bí
huyết mạch chi lực=lực lượng huyết mạch
vô phúc tiêu thụ=không có phúc để hưởng
địa phương này=nơi này
quật khởi con đường=con đường quật khởi
Lôi Vân Thụ=Lôi Vân Thụ
lôi thuộc tính=thuộc tính Lôi
nhục thân cường độ=cường độ nhục thân
Lôi hệ công pháp=công pháp hệ Lôi
một trận tỏa sáng=lập tức phát sáng
Tuy nhiên thứ này=tuy thứ này
Coi như vô dụng=cho dù vô dụng
hữu dụng tư nguyên=tư nguyên hữu dụng
màu tím đại thụ=đại thụ màu tím
đối với mấy đồ đệ nói=nói với mấy đồ đệ
hiện tại làm thế nào=bây giờ chúng ta làm gì đây
bụi đất tung bay=bụi bay đầy trời
thần hồn công kích bí pháp=bí pháp công kích thần hồn
ngươi là làm sao=sao ngươi lại
dưới trời sao cường đại nhất phi công=phi công cường đại nhất dưới bầu trời này
so với hắn còn thảm=còn thảm hơn cả hắn
La Mã đấu thú trường=trường đấu thú La Mã
năng lượng hạch tâm=hạch tâm năng lượng
về hướng sau cấp tốc thối lui=nhanh chóng lui ra phía sau
màu trắng lưu quang=lưu quang màu trắng
đạo thứ hai mũi tên=mũi tên thứ hai
tinh quang bộc phát=bắn ra ánh sáng
xung quanh sự vật=sự vật xung quanh
cường hãn vô cùng=vô cùng cường hãn
đấu thú trường=trường đấu thú
không khỏi phát sáng lên=lập tức trở nên sáng ngời
sinh mệnh năng lượng=năng lượng sinh mệnh
như thế khách khí=khách khí như thế
trong mắt hàn ý=hàn ý trong mắt
hoàn toàn phá hư=phá hư hoàn toàn
Mấy người ngữ khí=ngữ khí của mấy người
trước mắt dòng sông=dòng sông trước mắt
Bọn họ còn giống như=hình như bọn họ
không có tìm kiếm=chưa tìm
khả năng có=có thể có
đại sư huynh liền là đại sư huynh=đại sư huynh chính là đại sư huynh
đặc biệt bảo vật=bảo vật đặc biệt
đều nhìn không thấy=cũng không thể nhìn thấy
sư tôn trong tay=trong tay sư tôn
việc này chỉ sợ=chỉ sợ việc này
truyền thừa ký ức=ký ức truyền thừa
hắn chỗ ở=chỗ ở của hắn
không nghĩ đến=không ngờ rằng
trong suốt hư ảnh=hư ảnh trong suốt
tiểu xà=rắn nhỏ
màu trắng tiểu xà=rắn nhỏ màu trắng
Thủy nguyên tố=nguyên tố Nước
ẩn tàng khí tức=che giấu khí tức
đầu này tiểu xà=con rắn nhỏ này
không có nghĩ tới=không ngờ rằng
những người này bên trong=trong số những người này
theo xuất sinh bắt đầu=từ khi sinh ra
mình phụ mẫu=cha mẹ mình
Ngươi vì sao=vì sao ngươi
nhóm này ác nhân=nhóm ác nhân này
cấp thấp tư nguyên=tư nguyên cấp thấp
Bổn Nguyên thế giới=Thế Giới Bản Nguyên
Tinh Linh bộ lạc=bộ lạc Tinh Linh
tinh linh mẫu thụ=Tinh Linh Mẫu Thụ
Tinh Linh Thợ Săn=Thợ Săn Tinh Linh
lãnh địa bên ngoài=bên ngoài lãnh địa
Chúng nó tuy rằng=tuy chúng nó
tinh linh thợ săn=Thợ Săn Tinh Linh
Cự Lộc kỵ binh=Kỵ Binh Cự Lộc
lén lén lút lút=lén la lén lút
nhân số ưu thế=có ưu thế về số người
chuẩn xác vị trí=vị trí chuẩn xác
sợ hãi cùng phẫn nộ=sợ hãi và phẫn nộ
tảng đá nhỏ=Tiểu Thạch
miễn phí cung cấp=cung cấp miễn phí
quân phí vấn đề=vấn đề quân phí
kinh tế chế độ=chế độ kinh tế
màu mỡ chi địa=đất đai màu mỡ
cơ sở chức nghiệp giả=chức nghiệp giả cơ sở
công vụ nhân viên=nhân viên công vụ
chiến tranh học viện=học viện chiến tranh
pháp sư học viện=học viện pháp sư
thợ rèn học viện=học viện thợ rèn
chiêu mộ bên trong=trong quá trình chiêu mộ
hiện tại nói ra=bây giờ nói ra
thu nhận nhắc nhở=thông báo thu nhận
cấp hai pháp thuật=pháp thuật cấp hai
Lực từ hệ=hệ Lực Từ
bụi bạo thuật=Bụi Bạo Thuật
tây bắc khu vực=khu vực phía Tây Bắc
phá pháp chi nhãn năng lực=năng lực phá pháp chi nhãn
pháp thuật chập chờn=dao động pháp thuật
không có chút nào bất ngờ=không bất ngờ chút nào
tự nhiên tinh linh=Tinh Linh Tự Nhiên
tương tự thủ đoạn=thủ đoạn tương tự
đông bắc bộ thảo nguyên=thảo nguyên phía Đông Bắc
quan trọng tình báo=tình báo quan trọng
triệt để kiểm tra=kiểm tra triệt để
dự ngôn thuật=thuật tiên đoán
Tử vong nhất chỉ=Tử Vong Nhất Chỉ
Linh hồn hệ=hệ Linh Hồn
Linh hồn hệ pháp thuật=pháp thuật hệ Linh Hồn
đặc biệt đạo cụ=đạo cụ đặc biệt
không cao cấp bậc=cấp bậc không cao
[ Chú:=[ Chú thích:
tinh thiết trọng giáp= Tinh Thiết Trọng Giáp
lãnh địa bên trong=bên trong lãnh địa
Mỏ neo của thế giới=Mỏ Neo Thế Giới
Mỏ neo của Thế giới=Mỏ Neo Thế Giới
Con của Vận khí=khí vận chi tử
Phong Bạo Kết Giới=Kết Giới Phong Bạo
Giác Ưng kỵ sĩ=kỵ sĩ Giác Ưng
cường đại chủng tộc=chủng tộc cường đại
Ma quang kiếm=kiếm Pháp Thuật Ánh Sáng
Hoàn Vũ tệ=đồng Hoàn Vũ
Lam Tinh=Địa Cầu
Thực Nhân Ma=Ma Ăn Thịt Người
Khôi Ngưu=Trâu Khổng Lồ
Mà cũng liền tại=cũng vào
Đem việc này nói=nói việc này
từ chính hắn quyết định=đều do hắn quyết định
thuận miệng nói ra=thuận miệng nói
vương thất=Vương Thất
Ngưu Đầu Nhân=Người Đầu Trâu
là không tâm tư quản=không rảnh quan tâm
Đến mức nói=còn về nói
vì dân trừ hại=trừ hại cho dân
những thứ này kỳ thật=thật ra những chuyện này
cái kia giác ngộ=giác ngộ đó
Đương nhiên, như là=đương nhiên, nếu như
tứ đại gia tộc=bốn đại gia tộc
dạng này thế lực=thế lực giống như
mà đi toàn lực liều mạng=liều mạng, dốc hết toàn lực
Cái này không phù hợp ích lợi=chuyện này không phù hợp với lợi ích
cái này thế giới=thế giới này
Tuy nhiên cái này thế giới=tuy thế giới này
cải biến cái nhìn=thay đổi cách nhìn
sau cùng cũng sẽ từ từ=cuối cùng cũng sẽ từ từ
không có mảy may=không có chút
thì là tử vong=chính là tử vong
hắn như thế cái tiểu nhân vật=một nhân vật nhỏ như hắn
đều sẽ không có người=sẽ không có ai
ngập trời bối cảnh=bối cảnh ngập trời
kết quả kia thì không đồng dạng=thì kết quả sẽ không giống
dạng này người=loại người này
từ chính hắn làm quyết định=bảo hắn tự quyết định đi
bên kia giống như=hình như bên kia
xảy ra một chút xíu ngoài ý muốn=đã xảy ra một chút chuyện nhỏ ngoài ý muốn
, bóng người thì biến mất= thì bóng người lập tức biến mất
hướng về trang viên phương hướng=tiến về phương hướng trang viên
Nhưng lại tại hắn leo tường tiến vào trang viên về sau=nhưng sau khi hắn leo tường tiến vào trang viên
hắn liền bị=hắn lập tức bị
trận pháp cho khốn trụ=trận pháp trói chặt
nơi quái quỷ gì!=chỗ quái quỷ nào vậy?
đi không ra cái này khốn trận=không thoát khỏi khốn trận này được
hắn nhưng là=hắn chính là
sớm muộn muốn bị=sớm muộn gì cũng bị
trang viên chủ nhân=chủ nhân của trang viên
thời điểm dao động người=lúc gọi người
che đậy truyền tin trận pháp=trận pháp che đậy truyền tin
đều bố trí=cũng bố trí
Dù sao hiện tại cũng đã dạng này=dù sao bây giờ cũng đã như vậy rồi
cũng đã dạng này=cũng đã như vậy rồi
Đến mức dạng này=còn về việc làm như vậy
còn như vậy tiếp tục chờ đợi=nếu còn tiếp tục chờ đợi như vậy nữa
không quản được=không quan tâm được
hiếu kỳ mắt to=mắt to hiếu kỳ
không có cái gì tu vi khí tức=không có khí tức tu vi
khoẻ mạnh kháu khỉnh dáng vẻ=dáng vẻ khoẻ mạnh kháu khỉnh
cần phải rất tốt lừa gạt=chắc chắn rất dễ lừa gạt
đột nhiên xuất hiện tiểu nữ hài=tiểu nữ hài đột nhiên xuất hiện
so đo một phen=tính toán một phen
tự nhận là hòa ái dễ gần nụ cười=nụ cười tự nhận là hòa ái dễ gần
vào nơi này=vào đây
tiến nhập nơi này=tiến vào đây
trang viên chính thức chủ nhân=chủ nhân chính thức của trang viên
trang viên này bên trong trận pháp=trận pháp trong trang viên này
thì thừa ta một người=chỉ có một mình ta
vậy liền dễ làm=vậy thì dễ làm
phía xa tiểu nữ hài=tiểu nữ hài phía xa
một cái nụ cười=một nụ cười
hay không đừng cười nữa=đừng cười nữa hay không
cười đến rất=cười rất
Chính hắn làm sao=sao bản thân hắn lại
thu hồi nụ cười=thu lại nụ cười
hay không tới đây một chút=tới đây một chút hay không
đem tiểu nữ hài bắt lấy=bắt được tiểu nữ hài này
không là người xấu=không phải là người xấu
những người khác đồ vật=đồ vật của những người khác
cái này đáng chết gia gia=gia gia đáng chết này
ngắn ngủi giao lưu=giao lưu ngắn ngủi
hay không đang đùa bỡn ta=đang đùa bỡn ta hay không
Đi qua một phen=trải qua một phen
Ngươi thực ngốc=ngươi thật là ngốc
đem tất cả đều xé rách=xé rách tất cả
Ngọc Lan thành=thành Ngọc Lan
hướng phía trước chạy đi=chạy về phía trước
Vừa mới âm thanh kia=âm thanh vừa rồi
còn tốt tại thời khắc=may mà vào lúc
chủ tớ khế ước=khế ước chủ tớ
cái gì tác dụng=tác dụng gì
bên trong cơ thể=trong cơ thể
đầu kia tiểu xà=con rắn nhỏ kia
như là không thể=nếu như không thể
dạng này nhìn ta=nhìn ta như vậy
huyệt động cửa vào chỗ=chỗ cửa vào huyệt động
một tòa cung điện trước=trước một cung điện
một tòa cung điện=một cung điện
đan thất=phòng chứa đan dược
khí thất=phòng chứa vũ khí
Mỗi cái gian phòng=mỗi một căn phòng
đại lượng bảo vật=rất nhiều bảo vật
bất hủ thi thể=thi thể bất hủ
Một cái huyệt động bên trong=trong một huyệt động
hắn kiến thức=kiến thức của hắn
Đây quả thực=chuyện này quả thực
không theo thói quen ra bài=ra bài không theo lẽ thường
thật xinh đẹp cung điện=cung điện thật xinh đẹp
đem nó mang về=mang nó về
linh tuyền=Linh Tuyền
linh thạch khoáng mạch=khoáng mạch linh thạch
Cho ta thu=thu cho ta
thụ nhân=Người Cây
cự nhân=Người Khổng Lồ
Hỗn Độn quyền luật=Quyền luật Hỗn Độn
tin tức hồi phục=tin nhắn đáp lại
pháp thuật tháp triệu hoán hệ=tháp pháp thuật hệ Triệu Hoán
triệu hoán hệ=hệ Triệu Hoán
thử nhân=Người Chuột
hùng nhân=Người Gấu
ngưu đầu nhân=Người Đầu Trâu
bán nhân mã=Nửa Người Ngựa
ngân tệ=đồng bạc
kim tệ=đồng vàng
tử kim tệ=đồng tử kim
Clock Tower=Tháp Đồng Hồ
Hòn Đá Nhỏ=Tiểu Thạch
Ma quang kiếm=kiếm Pháp Thuật Ánh Sáng
Thanh Lân sáo trang=bộ giáp Thanh Lân
Hạt năng lượng lò=lò năng lượng hạt nhân
Điện năng hộ thuẫn=Lá Chắn Điện Năng
Thần kinh nguyên nhận lấy đồng bộ=đồng bộ với hệ thần kinh
sinh vật cơ giáp điều khiển=điều khiển người máy sinh học
Nương theo lấy nhắc nhở vang lên=sau khi một tiếng thông báo vang lên
ma sát âm thanh=âm thanh ma sát
khớp nối bên trên=chỗ khớp nối
thẳng tắp đứng vững=đứng thắng tắp
tại mặt đất phía trên=trên mặt đất
bên trong buồng lái=trong buồng lái
dưới đáy tất cả=tất cả phía dưới
bán kính 100 mét bên trong=trong bán kính 100 mét
tia hồng ngoại quét hình=quét tia hồng ngoại
Tuy nói hắn vừa rồi=tuy vừa rồi hắn
to lớn vô cùng=vô cùng to lớn
tiếp lấy biến sắc=sau đó sắt mặt lập tức xấu đi
cái kia quái vật=quái vật kia
thành đàn xuất hiện=xuất hiện thành đàn
kỳ ngộ cùng nguy hiểm=kỳ ngộ và nguy hiểm
liền điểm ấy phong hiểm=ngay cả chút nguy hiểm ấy
bắt lấy kỳ ngộ=lấy được kỳ ngộ
cái kia cái bóng=cái bóng kia
rất nhanh liền=rất nhanh đã
bãi rác phía dưới=phía dưới bãi rác
từng cái kinh hô lên=từng người kinh hô lên
ngay tại điều khiển=đang điều khiển
hỗn loạn bên trong=trong hỗn loạn
thật vất vả=vất vả lắm
mục tiêu phụ cận=gần mục tiêu
kia mấy đạo cái bóng=mấy cái bóng kia
Thôn Kim thử=chuột Thôn Kim
Mục tiêu cấp độ=cấp độ mục tiêu
Lực lượng hình=loại hình lực lượng
Thậm chí liền=thậm chí ngay cả
đều biến thành=cũng biến thành
kim loại cương châm=cương châm kim loại
rác thải phía trên=trên rác thải
cấp tốc quay người=nhanh chóng quay người
về hướng sau triệt hồi=lui nhanh về phía sau
tại sau lưng vang lên=vang lên sau lưng hắn
biểu lộ lập tức biến đổi=vẻ mặt lập tức thay đổi
hướng hắn bay nhào tới=phóng thẳng về hướng của hắn
Nương theo lấy máy móc âm thanh tiếng vọng=sau khi một âm thanh máy móc vang lên
trong nháy mắt triển khai=lập tức hiện ra
loá mắt điện quang=điện quang chói mắt
hộ thuẫn phía trên=trên lá chắn
trình độ kinh khủng=sự kinh khủng
tuyệt cao như thế thời cơ=thời cơ tuyệt vời như thế
phòng ngự cơ giáp=người máy phòng ngự
cơ giáp giao diện=giao diện người máy
sinh mệnh lực=điểm sinh mệnh
nhìn đến hôm nào=xem ra hôm nào
nặng nề thân máy=thân máy nặng nề
núi rác thải bên trên=trên núi rác thải
cỡ nào kịch liệt=kịch liệt cỡ nào
cũng đi theo nổi giận=cũng nổi giận
Mục tiêu triệu chứng sinh mệnh=dấu hiệu sinh mệnh của mục tiêu
kiểm trắc kết quả=kết quả kiểm tra
cơ giáp trong học viện=trong học viện người máy
cơ giáp đội ngũ=đội ngũ người máy
cấp tốc=nhanh chóng
cơ giáp trinh sát=người máy trính sát
sửa chữa cơ giáp=sửa chữa người máy
vận chuyển mạng lưới=mạng lưới vận chuyển
cơ hồ tất cả=gần như tất cả
chỉ định vị trí=vị trí chỉ định
giao dịch đối tượng=đối tượng giao dịch
Xác nhận qua đi=sau khi xác nhận
vận chuyển phí=phí vận chuyển
cá nhân trong trương mục=trong trương mục cá nhân
lập tức trong lòng=trong lòng lập tức
ngươi thật giống như=hình như ngươi
đối phương trong tay=trong tay đối phương
Phải biết.=phải biết rằng.
nhập môn phi công=phi công nhập môn
tấm chắn góc độ=góc độ của lá chắn
cung tiễn tốc độ=tốc độ của cung tiễn
đều là cái vấn đề=cũng là một vấn đề
bắt chước ngụy trang đại sảnh=đại sảnh mô phỏng
Dạng này a=như vậy à
có hắn tin tức thời điểm=khi nào có tin tức của hắn thì
ta có loại dự cảm=ta có một dự cảm
Sinh vật cơ giáp ở giữa chiến đấu=người máy sinh học chiến đấu
nhất liền là=nhất chính là
tự nhiên hi vọng=đương nhiên hắn hi vọng
chiến đấu trình độ=trình độ chiến đấu
mình chiến đấu trình độ=trình độ chiến đấu của bản thân
một cái nào thời cơ=một cơ hội nào
lập tức thông tri ngươi=sẽ lập tức thông báo cho ngươi
liền không có nhìn ra=cũng không nhìn ra
một điểm nhan sắc nhìn một cái=biết mặt
thần bí hệ pháp thuật=pháp thuật hệ Thần Bí
thần bí hệ pháp thuật=tháp pháp thuật hệ Thần Bí
cấp độ phân chia=phân chia cấp độ
Nhìn một hồi tin tức,=đọc tin tức một hồi
từ trên giường bò lên=bò dậy khỏi giường
đi vào bên ngoài=đi ra bên ngoài
thật mỏng sương tiêu=hạt sương thật mỏng
nghiêm trọng hủ hóa=ô nhiễm nghiêm trọng
gen thức tỉnh trình độ=mức độ thức tỉnh gen
gen thức tỉnh trình độ thấp người=người có mức độ thức tỉnh gen thấp
hút vào một ngụm=hít một hơi
đều sẽ dẫn phát=cũng sẽ làm cho
dị dạng quái vật=quái vật dị dạng
gen kỹ thuật=kỹ thuật gen
hiện tại gen kỹ thuật=kỹ thuật gen hiện tại
đều không cứu lại được đến=cũng không thể cứu được
quan trọng nguyên nhân một trong=một trong những nguyên nhân quan trọng
đoạt lại mặt đất=cướp lại mặt đất
sinh tồn hoàn cảnh=hoàn cảnh sinh tồn
Nhân mạng như cỏ rác=mạng người như cỏ rác
cũ nát áo khoác=áo khoác cũ nát
một sợi ánh mặt trời=một tia sáng mặt trời
siêu mạnh ma kháng=Kháng Ma Pháp Siêu Mạnh
Tự Động Chữa Trị=Tự Động Tu Sửa
Kiến trúc đặc tính=đặc tính kiến trúc
lãnh địa đặc tính=đặc tính lãnh địa
phong chi lữ nhân=Người Gió
điểm danh viện nghiên cứu Ma Văn của Hoàn Vũ xuất phẩm=sẽ ghi rõ nguồn gốc xuất sứ từ viện nghiên cứu Ma Văn Hoàn Vũ
vương giả cấp đơn vị=đơn vị cấp Vương Gỉa
thần sắc thống khổ=vẻ thống khổ
một cái lảo đảo=lảo đảo một cái
kém chút té ngã trên đất=xém nữa là ngã trên mặt đất
cho ta đuổi theo=đuổi theo cho ta
hệ thống thanh âm nhắc nhở=âm thanh thông báo của hệ thống
vị trí kia giống như=hình như vị trí đó
cũng muốn dùng=cũng phải dùng
một kích đánh giết=giết chết bằng một đòn
thành công đánh giết=đã giết chết
thành công cướp đoạt=đã cướp được
đối phương khí vận=khí vận của đối phương
Phó chức nghiệp=chức nghiệp phụ
một cái vấn đề=một vấn đề
Nhưng mà cũng thế=nhưng mà cũng đúng
đem người kia giết=giết chết người đó
ngài là làm sao=sao ngài
mấy ngàn mét cao=cao mấy ngàn mét
không có còn lại sinh lộ=không còn đường sống nào khác
Mà vừa mới người kia=mà người vừa rồi
thê thảm một chút=hơi thê thảm
tối đa chỉ là=cao nhất chỉ
xem ra chính mình=xem ra mình
sương trắng khu vực=khu vực sương trắng
vô tận thâm uyên=vực sâu vô tận
tất cả tới bao nhiêu người=có bao nhiêu người tới đây
cùng hắn không có một chút quan hệ=không có chút quan hệ gì với hắn
bức tử=ép đến chết
tại thí luyện bên trong=trong thí luyện
đồng dạng mệnh lệnh=mệnh lệnh tương tự
lại coi như biết=cho dù biết
nhìn trước mắt mỹ phụ=nhìn mỹ phụ trước mắt
tầng dưới chót công dân=công dân tầng dưới chót
cá nhân thực lực=thực lực cá nhân
cỡ nào vội vàng=vội vàng cỡ nào
đây là tại đùa ta=đang đùa ta à
cận thân chiến đấu thủ pháp=thủ pháp chiến đấu cận thân
cơ giáp điều khiển=điều khiển người máy
ngẫu nhiên xứng đôi=ghép đội ngẫu nhiên
Ngay tại xứng đôi đối thủ=đang tìm đối thủ
Ngay tại xứng đôi đối thủ, xin sau=đang tìm đối thủ, xin đợi...
Xứng đôi thành công=ghép đội thành công
ngay tại ngẫu nhiên phân phối sân bãi=đang phân phối sân đấu ngẫu nhiên
xứng đôi thành công nhắc nhở=thông báo ghép đội thành công
Tại cái này hủ hóa thế giới=trong thế giới biến dị này
trước mắt số liệu=số liệu trước mắt
Sân bãi phân phối hoàn tất=Sắp xếp sân đấu hoàn thành
Nương theo lấy một tiếng nhắc nhở=nương theo một tiếng thông báo
số liệu chuyển đổi=chuyển đổi số liệu
trước mắt chiến trường=chiến trường trước mắt
dị thường sắc bén=cực kỳ sắc bén
điều tra không đến=không điều tra được
cụ thể tham số=tham số cụ thể
đối phương cơ giáp=người máy của đối phương
điểm bền bỉ=điểm HP
bền bỉ=HP
phản điều tra hệ thống=hệ thống chống điều tra
trình độ nhất định=ở một mức độ nhất định
khác cơ giáp=người máy khác
cơn bão năng lượng thuẫn=Lá Chắn Bão Sấm Sét
đối diện cơ giáp=người máy đối diện
cơ hồ mỗi cái=gần như mỗi
đồng dạng lời nói=nói câu như vậy
hỏi đồng dạng lời nói=hỏi câu như vậy
có thể tin tưởng chỉ có=chỉ có thể tin tưởng
thẩm ngưng ngọc=Thẩm Ngưng Ngọc
những này đối thủ=những đối thủ này
quá mức để ý=quá để ý
nói thêm nữa nói nhảm=nói nhảm thêm nữa
có chút giương lên=hơi cong lên
tinh mang lóe lên=lóe lên tia sáng
thật sâu rung động=rung động mạnh liệt
đặc biệt cải tiến=cải tiến đặc biệt
hoàn mỹ đón đỡ=đỡ đòn hoàn mỹ
đỉnh cấp thiên tài=thiên tài đỉnh cấp
làm được loại trình độ này=làm được đến mức này
càng thêm nồng đậm=nồng đậm hơn
đối phương động tĩnh=động tĩnh của đối phương
kính pháp thuật=Kính Pháp Thuật
thu hồi tạp niệm=dứt bỏ suy nghĩ lung tung trong đầu
Thiên kiêu=thiên kiêu
Lãnh chúa=lãnh chúa
Tháp thực tập=Tháp Thực Tập
Bí cảnh thời gian=bí cảnh Thời Gian
Tân sinh chinh phạt=Chinh Phạt Tân Sinh
Mảnh nhỏ vị diện=Mảnh Nhỏ Vị Diện
Trái tim của thế giới=Thế Giới Chi Tâm
đặc biệt cảm tình=cảm tình đặc biệt
tôn kính thần sắc=vẻ tôn kính
thần hồn công pháp=công pháp Thần Hồn
thật tốt bế quan tu luyện=bế quan tu luyện thật tốt
trên người tạp chất=tạp chất trên người
bồi dưỡng chi ân=ân bồi dưỡng
tiểu gia tộc=gia tộc nhỏ
Đặc biệt thể chất=thể chất đặc biệt
Hỗn Độn thị giác=thị giác Hỗn Độn
hàng giảm giá danh sách=danh sách hàng giảm giá
vẫn tẫn chi bụi=bụi Vẫn Tẫn
môi giới thức tỉnh=vật dẫn thức tỉnh
huyền không ngọc mỏ=mỏ ngọc Huyền Không
huyền không ngọc=ngọc Huyền Không
dục hồn thạch mỏ=mỏ đá Dục Hồn
dục hồn thạch=đá Dục Hồn
hoàn mỹ cấp bậc=cấp bậc Hoàn Mỹ
Viêm long mã=ngựa Viên Long
long túc cỏ hạt giống=hạt giống cỏ Long Túc
Long túc cỏ=cỏ Long Túc
long túc cỏ=cỏ Long Túc
nghề làm vườn sư=thợ làm vườn
Mở mang thế giới=mở rộng thế giới
ngựa Viên Long sào huyệt=sào huyệt ngựa Viên Long
nhìn xa thiết bị=ống nhòm
ngao khuyển người=Người Chó
Người Chó lãnh địa=lãnh địa Người Chó
ma đạo pháo=Pháo Ma Đạo
áo thuật tháp=tháp pháp thuật
Ngao Khuyển tộc=tộc Chó Ngao Tạng
Ngao Khuyển tộc lãnh địa=lãnh địa tộc Chó Ngao Tạng
hệ Nguyên Tố áo thuật=pháp thuật hệ Nguyên Tố
tượng nhân tộc=tộc Người Voi
lang nhân tộc=tộc Người Sói
thần bí hệ pháp thuật sư=pháp thuật sư hệ Thần Bí
lai duy=Lai Duy
nguyên tố hệ tháp pháp thuật=tháp pháp thuật hệ Nguyên Tố
Quink tộc lãnh địa=lãnh địa tộc Người Chồn
vẫn hồn chi hơi thở=Thí Hồn Minh Chủng
vẫn hồn chi hơi thở=Thí Hồn Minh Trủng
Ảm Dạ Hô Hấp=Hô Hấp Trong Bóng Đêm
Cự hóa bản nổ tung ma đạn=Ma Đạn Nổ Tung bản nâng cấp
lược hồn chi thủ=Bàn Tay Bắt Hồn
chức nghiệp giả căn cứ huấn luyện=Căn cứ huấn luyện Chức Nghiệp Gỉa
đỏ Yayi=Hồng Long Yayi
thân ngoại hóa thân=Thân Ngoại Hóa Thân
cùng giai bên trong=trong cùng cấp
chấp pháp trưởng lão=trưởng lão chấp pháp
dò xét phạm vi=phạm vi dò xét
âm dương thần mài=Âm Dương Thần Mài
đào mộ quỷ=Quỷ Đào Mộ
lấy mạng quỷ=Quỷ Lấy Mạng
trung niên áo đen nam tử=nam tử trung niên áo đen
đối thủ tin tức=thông tin của đối thủ
quỷ dị góc độ=góc độ quỷ dị
viễn trình hình cơ giáp=người máy công kích từ xa
Ngọc bội Thân phận=Ngọc Bội Thân Phận
Ngọc bội thân phận=Ngọc Bội Thân Phận
tự động chữa trị=Tự Động Tu Sửa
địa chấn không chuyển=Động Đất Không Rung Chuyển
Khôn Kim Nham tường thành=tường thành Khôn Kim Nham
Brehemoth cự thú=thú khổng lồ Brehemoth
thú Thạch Gíac kỵ sĩ=kỵ sĩ cưỡi thú Thạch Gíac
Cự hóa bản Ma Hoàn Bạo Liệt=Ma Hoàn Bạo Liệt bản khổng lồ
lãnh chúa pho tượng=pho tượng Lãnh Chúa
từ phù đĩa bay.=đĩa bay Từ Phù
Vạn giới chư thiên=Chư Thiên Vạn Giới
Trùng nuốt thế giới=Trùng Nuốt Thế Giới
Lực lượng Vạn hóa=Lực Lượng Vạn Hóa
phấn không gian=Phấn Không Gian
Trùng nuốt thế giới=Trùng Nuốt Thế Giới
đặc sắc chiến đấu=chiến đấu đặc sắc
công dân số hiệu=số hiệu công dân
người tài khoản=tài khoản của ngài
Thuốc biến đổi gien=thuốc biến đổi gen
cơ sở vật liệu=vật liệu cơ sở
nghiêm trọng hư hao=hư hao nghiêm trọng
Vật phẩm tên=tên vật phẩm
Sinh mệnh năng nguyên=Sinh Mệnh Năng Nguyên
Vật phẩm giá cả=giá vật phẩm
Quyền mua hạn=quyền hạn mua
Hiệu quả tin tức=Công dụng
thượng tầng khu=khu thượng tầng
D77 khu=khu D77
mãnh liệt phản ứng dị thường=phản ứng cực kỳ dị thường
năng lượng cấp độ=cấp độ năng lượng
hủ hóa nguyên=mức độ biến dị
trung niên nam nhân=nam nhân trung niên
hủ hóa đầu nguồn=mức độ biến dị
Cơ Giáp học viện=học viện Người Máy
băng lãnh âm thanh=giọng nói lạnh lẽo
chữa bệnh thiết bị=thiết bị chữa bệnh
ánh mắt u oán=u oán ánh mắt
long nhân=Long Nhân
Hạt châu Không gian=Hạt Châu Không Gian
Hạt châu không gian=Hạt Châu Không Gian
Hài cốt Văn minh=Hài Cốt Văn Minh
thoáng qua tức thì=trôi qua rất nhanh
Thiên Vũ phong=núi Thiên Vũ
đạo lữ sự tình=chuyện đạo lữ
sư tôn nói qua=sư tôn đã nói
kiên định ngữ khí=ngữ khí kiên định
so ngươi tốt=tốt hơn ngươi
nỗ lực tu luyện=cố gắng tu luyện
đặc biệt năng lượng=năng lượng đặc biệt
thần sắc mừng rỡ=vẻ vui mừng
cái gì trứng=trứng gì
miệng hổ bên trong=trong miệng hổ
không gian xuyên toa=xuyên qua không gian
không gian thần thông=thần thông không gian
hai mắt nhắm nghiền=nhắm nghiền hai mắt
trận pháp đại sư=Trận Pháp sư
cũng là một trận hưng phấn=cũng hưng phấn một trận
Hổ Báo Kỵ quân doanh=quân doanh Hổ Báo Kỵ
Chức năng phương diện=về mặt chức năng
cái gì biến hóa=thay đổi gì
nhật viêm chi huy=Nhật Viêm Chi Huy
thiêu đốt hiệu quả=hiệu quả thiêu đốt
trấn hồn thạch=đá Trấn Hồn
binh chủng số lượng hạn mức tối đa=số lượng binh chủng tối đa
lãnh địa phụ cận=ở gần lãnh địa
cự nhân tộc=tộc Người Khổng Lồ
tự nhiên Tinh Linh tộc=tộc Tinh Linh Tự Nhiên
cao cấp chủng tộc=chủng tộc cao cấp
trung cấp chủng tộc=chủng tộc trung cấp
cấp thấp chủng tộc=chủng tộc cấp thấp
cái gì sơ sót=sơ sót gì
lục long Valerie=Lục Long Valerie
đáng sợ chủng tộc=chủng tộc đáng sợ
ác ma thống lĩnh=Thống Lĩnh Ác Ma
ác ma lãnh chúa=Lãnh Chúa Ác Ma
Thâm Uyên Ma vương=Ma Vương Thâm Uyên
Thâm Uyên ma tướng=Ma Tướng Thâm Uyên
cường hãn thân thể=thân thể cường hãn
né tránh không kịp=không kịp né tránh
phẫn nộ gào thét=gào thét phẫn nộ
lãnh chúa pháo đài=pháo đài lãnh chúa
nổ tung ma đạn=Ma Đạn Nổ Tung
ác ma=Ác Ma
chuyên nghiệp huấn luyện=huấn luyện chuyên nghiệp
bén nhạy dị thường=cực kỳ nhạy bén
tài liệu cá nhân=thông tin cá nhân
đọa lạc giả=Người Đọa Lạc
một cái xoay người=xoay người một cái
chiến đấu đếm ngược=đếm ngược chiến đấu
sương mù bên trong=trong sương mù
thân ở sương mù bên trong=đang ở trong sương mù
sương mù phạm vi=phạm vi sương mù
Tiến vào sương mù phạm vi về sau=sau khi tiến vào phạm vi sương mù
hướng về sau cấp tốc thối lui=nhanh chóng lui về phía sau
quỷ dị hồng mang=hồng mang quỷ dị
tại phía sau hắn sáng lên=sáng lên sau lưng hắn
bạo cướp mà đến=bắn nhanh đến
Vẻn vẹn một kích=chỉ với một kích
quỷ dị ánh sáng=ánh sáng quỷ dị
cũng không ngờ tới,=cũng không ngờ rằng
điều khiển năng lực=năng lực điều khiển
Vừa rồi một kích=một kích vừa rồi
tiến công tư thái=tư thái tiến công
Mơ hồ trong đó=trong mơ hồ
to lớn bóng đen=bóng đen to lớn
ngay tại chiến đấu kịch liệt=đang chiến đấu kịch liệt
hoàng kim võ giả=Võ Giả Hoàng Kim
kinh khủng chiến tích=chiến tích kinh khủng
như thế nào tâm tình của mình=tâm tình của mình như thế nào
khổng lồ bóng đen=bóng đen khổng lồ
ngu ngơ đám người=đám người ngu ngơ
hồ nghi=nghi ngờ
muốn ăn đòn ngữ khí=ngữ khí muốn ăn đòn
vậy liền trực tiếp=vậy thì trực tiếp
dạng này hiệu quả=như vậy hiệu quả
Nghe được lời=nghe thấy lời
liền là trầm xuống=lập tức trầm xuống
cự trảo=móng vuốt khổng lồ
Mạc Lạc Figo=Mạc Lạc Phi
tâm mạch rung động=Tâm Mạch Rung Động
Thư sáng tạo=Sách Sáng Tạo
Bất tử nguồn suối=Nguồn Suối Bất Tử
số 1 thuốc biến đổi gien=thuốc biến đổi gen số 1
vào hắn toàn thân=khắp cả người hắn
kịch liệt đau nhức=đau nhức kịch liệt
không có chuyện gì xảy ra=không xảy ra chuyện gì
một sợi ánh nắng=một tia nắng
chiếu xạ tiến trong phòng=chiếu vào trong phòng
từ trên giường đứng lên=ngồi bật dậy khỏi giường
cuối hành lang thang máy=thang máy ở cuối hành lang
đặc thù phòng=phòng đặc biệt
đặc thù phòng cửa phòng=cánh cửa của phòng đặc biệt
từ bên trong chạy đến=từ trong đó chạy ra
mấy đạo nhân ảnh=mấy bóng người
miệng bên trong hùng hùng hổ hổ=mở miệng hùng hổ nói
miệng bên trong=trong miệng
còn không biết xấu hổ nói=nói mà không biết xấu hổ à
Đều đừng nói nhảm=đừng nói nhảm nữa
tại 7 giờ trước=trước 7 giờ
hẳn là có thể=chắc là có thể
muốn bất chấp=phải bất chấp
tầng dưới chót tiểu nhân vật=tiểu nhân vật tầng dưới chót
cùng loại người này ở chung=ở chung với loại người này
thân thể tình trạng=tình trạng thân thể
Kinh hỉ phía dưới=sau khi kinh hỉ
mình thông tin cá nhân=bảng thông tin cá nhân của mình
giao diện trên tin tức=thông tin trên giao diện
giao diện trên=trên giao diện
thành Bắc khu=khu vực thành Bắc
7 giờ trước=trước 7 giờ
kỹ càng vị trí=vị trí cụ thể
cảnh cáo ta nhưng nói trước=ta phải cảnh báo ngươi trước
hậu cần bộ đội=bộ đội hậu cần
từng cái đội ngũ ở giữa=giữa nhiều đội ngũ
muốn đi khắp tại=phải đi khắp
tùy thời có khả năng sẽ gặp phải nguy hiểm=có thể sẽ gặp nguy hiểm bất cứ lúc nào
thoát ly đội ngũ=rời khỏi đội ngũ
nếu là tùy tiện=nếu ngươi tùy tiện
, cũng đừng trách ta= thì cũng đừng trách ta
không nhắc nhở qua ngươi=không nhắc nhở ngươi
cái mạnh miệng mềm lòng người=người mạnh miệng nhưng mềm lòng
không chịu nổi chuyện cũ=chuyện cũ đau buồn
đến địa phương khác=đến chỗ khác
cùng người trò chuyện đi=trò chuyện với người khác
nói liên tục xin lỗi=liên tục nói xin lỗi
thân thể tố chất=tố chất thân thể
bình thường độc dược=độc dược bình thường
rất tốt giải quyết=giải quyết rất tốt
Tiếp xuống một đoạn thời gian=trong một đoạn thời gian tiếp theo
thì lâm vào bận rộn bên trong=trở nên cực kỳ bận rộn
nổ lô âm thanh=âm thanh nổ lô
đây là đang làm gì=đang làm gì vậy
sư tôn vị trí=vị trí của sư tôn
tại luyện=đang luyện
cần phải là rất cao=chắc chắn là rất cao
tu luyện đan dược=đan dược tu luyện
nổ lô tiếng vang=âm thanh nổ lô
hạ cấp đan dược=đan dược hạ cấp
cao cấp đan dược=đan dược cao cấp
trên người hắn tư nguyên=tư nguyên trên người hắn
nhiều toa thuốc hơn=nhiều đan phương hơn
rất khó làm đến=rất khó làm được
vì đan dược phát sầu=đau đầu vì đan dược
luyện đan tạo nghệ=tạo nghệ luyện đan
theo đan lô bên trong=từ trong đan lô
đan lô bên trong=trong đan lô
trung giai đan dược=đan dược trung cấp
thời gian nhất định luyện tập=thời gian luyện tập nhất định
cao giai đan dược=đan dược cao cấp
giúp ta mua=mua giúp ta
không có suy nghĩ nhiều=không suy nghĩ nhiều
thường gặp đan dược=đan dược thường gặp
phổ thông đan dược=đan dược phổ thông
Cái này trong mắt hắn,=trong mắt hắn, chuyện này
Cái này trong mắt hắn=chuyện này trong mắt hắn
hắn lập tức đã=hắn đã
trắng như tuyết đan dược=đan dược trắng như tuyết
một cái tiểu nữ hài=một tiểu nữ hài
phiêu phù=trôi nổi
không có sao chứ=không sao chứ
không có chút nào tu vi=không có chút tu vi nào
chuyện này hàn ý=hàn ý này
không có tu vi người bình thường=người bình thường không có tu vi
liền chịu không được=sẽ không chịu được
không có chút tu vi tiểu nữ hài=tiểu nữ hài không có chút tu vi
ung quanh hàn ý=hàn ý ung quanh
hệ thống thu đồ đệ thành công tiếng nhắc nhở=tiếng nhắc nhỏ thu đồ đệ thành công của hệ thống
Lúc trước nếu là=nếu lúc trước
cái này tốc độ lên cấp=tốc độ lên cấp này
gật gật đầu=gật đầu
hệ thống phạm vi dò xét=phạm vi dò xét của hệ thống
đặc biệt thể chất=thể chất đặc biệt
đặc biệt huyết mạch=huyết mạch đặc biệt
một cái thế lực=một thế lực
Thái Âm thần lực=Thái Âm Thần Lực
to lớn lực phá hoại=lực phá hoại to lớn
còn lại tuổi thọ=tuổi thọ còn lại
cụ thể uy lực=uy lực cụ thể
chưa từng thử qua=chưa từng thử
nhưng là muốn đến hẳn là=nhưng có lẽ là
dù sao đây là=dù sao thì đây cũng là
không có đạt tới=không đạt tới
cực độ lạnh lẽo=cực kỳ lạnh lẽo
nhu thuận lông tóc=bộ lông mềm mại
nó trên người=trên người nó
tuốt mèo khoái lạc=niềm vui vuốt lông mèo
kinh khủng thiên tư=thiên tư kinh khủng
thần bí hề hề=ra vẻ thần bí
Đối tại hắn hiện tại tới nói=đối với hắn bây giờ thì
bình thường sự tình=chuyện bình thường
theo người khác chỗ đó=từ chỗ của người khác
dò xét nghe được=nghe ngóng được
đệ nhất gia tộc=gia tộc đệ nhất
Nghe được tin tức này=nghe thấy tin tức này
không có nghe thấy=không nghe thấy
không có nhìn thấy=không nhìn thấy
sự tình nếu=nếu chuyện
Lúc trước không phải=không phải lúc trước
mẫu thân hắn thế nào=mẹ hắn sao rồi
cùng ngươi cùng nhau trở về=trở về cùng ngươi
tân thủ thôn=thôn tân thủ
miễn cưỡng có thể=có thể miễn cưỡng
Nếu là gặp phải=nếu như gặp phải
An bài tốt tất cả sau này=sau khi an bài xong mọi chuyện
Vân Mộng thành=thành Vân Mộng
phồn hoa trình độ=độ phồn hoa
thí luyện kết quả=kết quả thí luyện
thí luyện kết quả đã ra tới=đã có kết quả thí luyện
hững hờ mà hỏi=hững hờ hỏi
ánh mắt băng lãnh=ánh mắt lạnh lẽo
khóe miệng nhấc lên=khóe miệng lộ ra
lãnh huyết gia tộc=gia tộc lãnh huyết
chỉ có hắn sống tiếp được=chỉ còn mình hắn sống
thế lực đông đảo=có rất nhiều thế lực
cùng chúng ta so ra=so với chúng ta thì
thiên phú cho dù=cho dù thiên phú
hắn một người=một mình hắn
nếu là hắn=nếu như hắn
sau cùng thí luyện=thí luyện sau cùng
Hư nhược âm thanh=âm thanh hư nhược
trùng điệp gật đầu=gật đầu thật mạnh
các ngươi huynh muội hai cái=hai huynh muội các ngươi
thật tốt sống sót=sống thật tốt
Băng lãnh nước mưa=nước mưa lạnh lẽo
làm ra khí lực cả người=dốc hết tất cả sức lực
Nghe sau lưng chế giễu=nghe tiếng chế giễu sau lưng
hắn rời đi bối cảnh=cảnh hắn rời khỏi
quá thấp điểm=quá thấp
không quan trọng nói=không để ý nói
trở lại vị trí bên trên=trở về vị trí của mình
đối những người còn lại=những người còn lại
liền đem chuyện này ném sau ót=đã ném chuyện này ra sau ót
là liền xem như=cũng chỉ là
còn chưa đủ lấy để=còn chưa đủ làm cho
khác một đội ngũ=một đội ngũ khác
mười phút đồng hồ thời gian=thời gian mười phút đồng hồ
đội ngũ đoạn trước nhất=phía trước nhất của đội ngũ
lại lần nữa đi vào=hắn lại lần nữa đi đến
chỉ là nhìn=chỉ nhìn
đồng tình ánh mắt bên trong=trong ánh mắt đồng tình
Nhưng mà còn đi chưa được mấy bước=nhưng hắn còn chưa đi được mấy bước
thần sắc kiêu căng thanh niên=thanh niên với vẻ mặt kiêu ngạo
đối một cái thần sắc kiêu căng thanh niên nói=nói với một thanh niên có vẻ mặt kiêu ngạo
Trước sau thái độ=thái độ trước sau
mỗi cái bộ đội biểu hiện=biểu hiện của mỗi tổ đội
đến tiến hành ban thưởng=để ban thưởng
cho nhất định ban thưởng=đưa ra phần thường nhất định
Bất quá thời gian qua một lát=chỉ mới trong thời gian thật ngắn
xếp hàng nhân số=số người xếp hàng
cái đội ngũ này=ở đội ngũ này
vừa rồi động tĩnh=động tĩnh vừa rồi
thực lực không tệ phi công=phi công thực lực không tệ
muốn bị=sẽ bị
lần này chuyển chính thức thời cơ=thời cơ chuyển chính thức lần này
Chính quy bộ đội=bộ đội chính quy
Chính quy bộ đội danh ngạch=danh ngạch bộ đội chính quy
đối bọn hắn tới nói cực kỳ trọng yếu=cực kỳ quan trọng đối với bọn hắn
liền không người hỏi thăm=không ai thèm để ý
cùng phía trước đồng dạng=giống như trước đó
Gen thức tỉnh độ=độ thức tỉnh gen
bãi rác khu vực=khu vực bãi rác
vẫn là không có=vẫn không
đem hắn đuổi đi=đuổi hắn đi
là cố ý tới quấy rối=cố ý tới đây để quấy rối
quảng trường bên trên=trên quảng trường
Thật chẳng lẽ muốn=chẳng lẽ thật sự phải
nơi hẻo lánh bên trong=trong một góc khuất
một cái quạnh quẽ chiêu mộ điểm=một điểm chiêu mộ vắng hoe
chiêu mộ điểm=điểm chiêu mộ
giống như cũng=hình như cũng
đều chỉ có ba cái=cũng chỉ có ba người
rốt cục vẫn là=cuối cùng hắn vẫn
chiêu mộ điểm trước mặt=trước mặt điểm chiêu mộ
không người hỏi thăm=không ai hỏi thăm
Các ngươi nơi này=chỗ các ngươi
Cùng cái khác đội ngũ đồng dạng=giống với những đội ngũ khác
sớm có đoán trước=đã sớm đoán được
ôn hòa giọng nữ=giọng nữ ôn hòa
nhìn xem hắn=nhìn hắn
Đã dạng này=nếu đã như vậy
Ngươi xác định=ngươi chắc chắn
Đầu trọc hán tử=hán tử đầu trọc
như thế một vòng to=một vòng to như thế
thiên phú S cấp đệ tử=đệ tử có thiên phú cấp S
thiên phú SS cấp đệ tử=đệ tử có thiên phú cấp SS
thiên phú SSS cấp đệ tử=đệ tử có thiên phú cấp SSS
bắt mắt ánh sáng=ánh sáng bắt mắt
hệ thống dò xét phạm vi=phạm vi dò xét của hệ thống
khuếch trương lớn thêm=lớn hơn
chung quanh phương viên một vạn dặm phạm vi=trong phạm vi 10 ngàn dặm xung quanh
Như là dựa theo=nếu dựa theo
khuếch trương lớn lên=mở rộng hơn
tràn ngập nguy hiểm sinh mệnh khí tức=khí tức sinh mệnh đang tràn đầy nguy hiểm
còn như trong gió chập chờn hỏa diễm=giống như ngọn lửa chập chờn trong gió
tùy thời đều có dập tắt khả năng=có thể tắt bất cứ lúc nào
thầm nghĩ trong lòng một tiếng=thầm nghĩ trong lòng
đen nhánh vết nứt không gian=vết nứt không gian đen nhánh
linh chu phía trước=phía trước linh chu
liền tiến vào=lập tức tiến vào
dài dằng dặc một thế kỷ=một thế kỷ dài dằng dặc
bé trai bắn tới=bắn về phía bé trai
lấy tốc độ mà mắt thường cũng có thể thấy được khôi phục=khôi phục với tốc độ mà mắt thường cũng có thể thấy được
ngắn ngủi khôi phục=khôi phục ngắn ngủi
cái hố bên trong=trong hố
trên thân thể thương thế=vết thương trên người
như cũ lạnh buốt=lạnh buốt như cũ
linh hồn thương thế=vết thương linh hồn
Đen nhánh trong không gian=trong không gian đen nhánh
một đạo ánh sáng nhạt=một tia sáng nhỏ nhoi
Tại mảnh này đen nhánh trong không gian=trong vùng không gian đen nhánh này
một mực tại bên cạnh=vẫn luôn ở bên cạnh
tại trong đầu của hắn xẹt qua=liên tục hiện ra trong đầu hắn
mê hoặc âm thanh=âm thanh mê hoặc
tự mình lựa chọn quyền lợi=quyền lựa chọn của chính mình
thần hồn cường độ=cường độ thần hồn
thần hồn phía trên=trên thần hồn
xung quanh hắc ám=hắc ám xung quanh
tiểu tiểu thân ảnh=bóng người bé nhỏ
cái này mảnh hắc ám=mảnh hắc ám này
tiểu tiểu thân ảnh bên cạnh=bên cạnh bóng người nhỏ bé
cùng ta nói=nói với ta
mạnh được yếu thua thế giới=thế giới mạnh được yếu thua
liền vận mệnh của mình đều không điều khiển được=còn không điều khiển được vận mệnh của mình
tàn khốc sự tình=chuyện tàn khốc
tại tu vi thấp thời điểm=lúc tu vi thấp
ma văn tinh bạo phi mâu=phi mâu ma văn Tinh Bạo
ma văn tinh bạo tiễn=tiễn ma văn Tinh Bạo
Độc nhãn lãnh chúa Người Khổng Lồ=lãnh chúa Người Khổng Lồ Một Mắt
Tê liệt tử quang=Tia Sét Tê Liệt
Vân gia bảo=Vân Gia Bảo
chiếm diện tích cực lớn trang viên=trang viên chiếm diện tích cực lớn
kiến trúc phần lớn=phần lớn kiến trúc
trang nghiêm nghiêm túc cảm giác=cảm giác nghiêm túc trang nghiêm
thành lập mới bắt đầu=mới bắt đầu thành lập
ở đây đặt chân=đặt chân ở đây
tòa này thành trì=tòa thành trì này
không còn năm đó huy hoàng=không còn huy hoàng của năm đó
theo đại điện bên ngoài=từ bên ngoài đại điện
theo ngoài cửa=từ ngoài cửa
ngay tại truy tra=đang truy tra
để hắn cẩn thận=nói hắn cẩn thận
Đúng, gia chủ=vâng, gia chủ
Đúng, sư tôn=vâng, sư tôn
trang vườn=trang viên
Vương Đằng phân thân=phân thân của Vương Đằng
thì làm một cái quyết định=đã làm ra một quyết định
địch trên thân thể người=trên người kẻ địch
Loại này ấn ký=loại ấn ký này
tại khoảng cách nhất định bên trong=trong khoảng cách nhất định
cái này bí ẩn tin tức=tin tức bí ẩn này
như thế kỳ hoa gia tộc=gia tộc kỳ hoa như thế
dạng này một cái gia tộc=một gia tộc như vậy
đối tu vi của mình thực lực rất có lòng tin=rất có lòng tin đối với tu vi thực lực của mình
như thế phiền phức=phiền phức như thế
cao thủ cũng là không ít=cũng có không ít cao thủ
bản thể cùng phân thân=bản thể và phân thân
còn lại liền dễ làm=còn lại thì dễ làm
so với đối phương cao=cao hơn đối phương
nếu là còn nếu=nếu như còn
chính mình cũng có chút hoài nghi=cũng có hơi hoài nghi bản thân
trang viên cửa chính=cửa chính của trang viên
nếu là người không đủ=nếu như không đủ người
Mộng Ảnh tiểu đội=tiểu đội Mộng Ảnh
làm cho người hoảng sợ khí tức=khí tức làm cho người ta hoảng sợ
vẫn là muốn có=vẫn là phải có
đời thứ tư lão tổ=lão tổ đời thứ tư
hắn tự nhiên=hắn đương nhiên
tiếp xúc không đến=không được tiếp xúc
bằng bạc đai lưng=đai lưng bằng bạc
bọn họ tung tích=tung tích của bọn họ
ma long hóa=hình thái Ma Long
linh hồn thế giới=thế giới linh hồn
tàn khốc thế giới=thế giới tàn khốc
thôn thiên ma công=Thôn Thiên Ma Công
thị huyết ma đao=Thị Huyết Ma Đao
ma thần giáp=Ma Thần Giáp
huyết ma thần=Huyết Ma Thần
ma tâm đan=Ma Tâm Đan
Lý Đại trâu=Lý Đại Ngưu
sáu tay quỷ la pho tượng=pho tượng Qủy La Sáu Tay
quỷ la=Qủy La
huyết hải=biển Máu
Tích dịch nhân=Người Kỳ Nhông
Thần bí hệ pháp thuật sư=pháp thuật sư hệ Thần Bí
phân thành=Phân Thành
anh linh=Anh Linh
thực chất giống như sát ý=sát ý giống như thực chất
đem ấn ký cho trừ đi=đã giải trừ xong ấn ký đó
xà nhân=Người Rắn
xà nhân tộc=Tộc Người Rắn
Xà Nhân Tộc=Tộc Người Rắn
Xà Nhân tộc=Tộc Người Rắn
thâm thúy đôi mắt=đôi mắt thâm thúy
bí ẩn tình báo=tình báo bí ẩn
thảm liệt chiến đấu=chiến đấu thảm liệt
phòng ngự đại thuật=đại thuật phòng ngự
thần hồn công sát=công sát thần hồn
đối phương thần hồn=thần hồn của đổi phương
thành công ký sinh=ký sinh thành công
tên này cường giả=tên cường giả này
tu luyện cảm ngộ=cảm ngộ tu luyện
cần thiết thời khắc=lúc cần thiết
hồn chủng=Hồn Chủng
trước mắt tu vi=tu vi hiện tại
bản thể một khi=một khi bản thể
chỉ nhưng mà=chỉ có điều
trân quý tư nguyên=tư nguyên trân quý
huyết mạch bí thuật=bí thuật huyết mạch
bình thường bí thuật=bí thuật bình thường
nhất định cảnh giới=cảnh giới nhất định
trung kiên lực lượng=lực lượng trung kiên
ngoại lai thế lực=thế lực ngoại lai
đặc biệt độc dược=độc dược đặc biệt
phổ thông đồ vật=đồ vật bình thường
chết nguy hiểm=nguy hiểm chết người
hắn lần thứ nhất=lần đầu tiên hắn
lớn như vậy thành trì=thành trì lớn như vậy
người ta nhất ánh mắt=ánh mắt người khác nhất
cao lớn thành trì=thành trì cao lớn
sớm như vậy đã trở lại=về sớm như vậy
hiện tại tình huống=tình huống hiện tại
đạo ôn nhuận như ngọc âm thanh=âm thanh ôn nhuận như ngọc
đem ba người đều đánh thức=đánh thức ba người
mảy may nhìn không ra=không nhìn ra một chút
khẩn trương khí tức=khí tức khẩn trương
phổ thông người dân=người dân bình thường
mà nói là như vậy=thì chính là như vậy
cái kia có chút thực lực thế lực=thế lực có chút thực lực
nghị sự đại điện=đại điện nghị sự
như vậy ngã xuống=ngã xuống như vậy
lão phu ý kiến=ý kiến của lão phu
đạo có chút âm thanh tức giận=giọng nói có chút tức giận
dạng này cãi lộn=cãi lộn như vậy
cái gì ý nghĩa=ý nghĩa gì
gia tộc bên trong=trong gia tộc
vương thành cục thế=thế cục ở vương thành
nhìn cái chủ ý này=thấy chủ ý này
liền bận bịu xưng là=vội vàng đồng ý
tu luyện quyết tâm=quyết tâm tu luyện
tu luyện cuồng ma=tu luyện điên cuồng
bí ẩn tin tức=tin tức bí mật
không tin tức trọng yếu=tin tức không quan trọng
quá lớn liên luỵ=liên luỵ quá lớn
bảo mệnh chi vật=đồ bảo mệnh
cuồng bạo năng lượng=năng lượng cuồng bạo
màu đen cuồng bạo năng lượng=năng lượng cuồng bạo màu đen
tinh hồng tròng mắt=mắt màu đỏ như máu
bình thường chi sắc=vẻ bình thường
hắc bào bên trong=trong áo bào đen
sự tình bại lộ=chuyện này bị bại lộ
đối ngươi ra tay=ra tay với ngươi
Hắc bào người=người mặc áo bào đen
Đã gần như=gần như đã
Đúng, bệ hạ=vâng, bệ hạ
muốn hay không giết hắn=có cần giết hắn hay không
Ngươi nếu là=nếu như ngươi
giúp ngươi xuất thủ=ra tay giúp ngươi
quật khởi cơ hội=cơ hội quật khởi
tiền nhân động phủ=động phủ tiền nhân
so ngươi thấp=thấp hơn ngươi
tuyệt thế cường giả=cường giả tuyệt thế
tu vi có đột phá=có đột phá tu vi
lực từ hệ=hệ Lực Từ
nam bộ hải vực=vùng biển phía Nam
trung tâm chế tạo=Viện Chế Tạo
công nhân kiến trúc=thợ xây
đông bắc thảo nguyên=cánh đồng cỏ hướng đông bắc
lần này quy mô=quy mô lần này
so với lần trước còn lớn hơn=còn lớn hơn lần trước
cơ giáp hạng nặng bộ đội=đội quân người máy hạng nặng
đều bị phái đi ra=cũng bị phái ra
Liên Bang thông cáo=thông báo Liên Bang
Liên Bang kênh=kênh liên Bang
công dân nhóm=nhóm công dân
kiếm tiền thời cơ=cơ hội kiếm tiền
ngàn năm một thuở=ngàn năm một lần
tuỳ tiện bỏ lỡ=dễ dàng bỏ qua
phổ thông công dân=công dân phổ thông
chiến tuyến hậu phương=phía sau chiến tuyến
dạng gì quái vật=quái vật dạng gì
lần này bầu không khí=bầu không khí lần này
cơ giáp hạng nặng=người máy hạng nặng
chiến lược tính vũ khí=vũ khí chiến lược
lần này đối mặt=đối mặt lần này
có nhiều khó giải quyết=khó giải quyết cỡ nào
độ khó cao động tác=động tác độ khó cao
Cơ giáp tham số=Thông số người máy
Đại địa lò luyện=Lò Luyện Mặt Đất
chưa giải khóa=chưa mở khóa
cần chỉ định bộ kiện=cần phụ kiện chỉ định
mặt đất phòng hộ=Phòng Vệ Mặt Đất
hủ hóa độ=độ biến dị
to lớn khác nhau=khác nhau to lớn
Mà liền tại hắn=mà ngay khi hắn
cao cấp đạo sư=đạo sư cao cấp
chỉ huy phó=phó chỉ huy
Trí Hàng tập đoàn=tập đoàn Trí Hàng
béo đạo sư=đạo sư béo
trí năng ô tô=ô tô thông minh
cơ hồ nắm trong tay=gần như nắm trong tay
ưu tú nhất học viên=học viên ưu tú nhất
mấy cái ưu tú nhất học viên một trong=một trong mấy học viên ưu tú nhất
năm nay mấy cái ưu tú nhất học viên một trong=một trong mấy học viên ưu tú nhất năm nay
Nhưng coi như thế=nhưng cho dù như vậy
ưu tú nhất tài nguyên=tài nguyên ưu tú nhất
công tử ca nhóm=nhóm công tử ca
mập hòa thượng=hòa thượng mập
đen nhánh tròng mắt=tròng mắt đen nhánh
Thâm uyên giống như=giống như thâm uyên
đây tất cả=tất cả những chuyện này
đều muốn chờ=đều phải chờ
khẩn yếu nhất=quan trọng nhất
nhưng lại không có=nhưng vẫn không
chuyên môn phụ trách=chuyên phụ trách
đệ nhất đại gia tộc=đại gia tộc đệ nhất
đã liên lạc không được=đã không còn liên lạc được với
mỗi khắp ngõ ngách=khắp mỗi ngõ ngách
tịnh hồn cát=cát Tịnh Hồn
mỏ linh tâm thủy tinh=mỏ thủy tinh Linh Tâm
linh tâm thủy tinh=thủy tinh Linh Tâm
lưu ảnh thạch=đá Lưu Ảnh
long phách tinh=Long Phách Tinh
Triển Dực thành=thành Triển Dực
hoàng kim thạch mỏ=mỏ đá Hoàng Kim
từ nổi xoắn ốc xe bắn tên=xe bắn tên xoắn ốc Từ Phù
tinh bạo thạch=đá Tinh Bạo
chiến tranh cổ thụ=Cổ Thụ Chiến Tranh
Cự Lộc kỵ sĩ=kỵ sĩ Cự Lộc
khác dị tộc lãnh địa=lãnh địa của dị tộc khác
dị tộc lãnh địa=lãnh địa dị tộc
thương phẩm số lượng=số lượng thương phẩm
Vì lẽ đó=vì vậy
Đánh giết sau=sau khi giết chết
cực hạn khoảng cách=khoảng cách cực hạn
Trong lòng tuy rằng=tuy trong lòng
đặc biệt chức năng=chức năng đặc biệt
nguyên tố chi hoàn=Nguyên Tố Chi Hoàn
Nguyên tố lưu phái=hệ Nguyên Tố
kiến trúc công nhân=thợ xây
lãnh chúa thế lực=thế lực lãnh chúa
toàn bộ thanh lý=thanh lý toàn bộ
còn lại hai cái phương hướng=hai phương hướng còn lại
Cho tới còn lại hai cái phương hướng=còn về hai phương hướng khác
Nhưng gần nhất một cái=nhưng một cái gần nhất
người loại lãnh chúa=lãnh chúa nhân loại
nhân loại lãnh địa=lãnh địa nhân loại
nó biên giới=biên giới của nó
mở rộng quá trình bên trong=trong quá trình mở rộng
ma long=Ma Long
cường hãn thể chất=thể chất cường hãn
biến thái thiên phú=thiên phú biến thái
rồng ngâm=Long Ngâm
hồng long Yayi=Hồng Long Yayi
lam long Jerez=Lam Long Jerez
hồng long Gonzalez=Hồng Long Gonzalez
hắc long Neo=Hắc Long Neo
ấu niên kỳ=thời kỳ ấu niên
thiếu niên kỳ=thời kỳ thiếu niên
phong nguyên tố=nguyên tố Gió
chậm không lên bao nhiêu=không chậm quá nhiều
đồng hương trước mặt=trước mặt đồng hương
như thế nông cạn người=người nông cạn như thế
cự long=Cự Long
thập phần mừng rỡ=cực kỳ mừng rỡ
cự long chi chủ=Cự Long Chi Chủ
long thú=Long Thú
tam giác trận hình=trận hình tam giác
cuồng phong lực lượng=lực lượng cuồng phong
như vậy ung dung qua=nhẹ nhàng như vậy
vững vàng ngồi=ngồi vững vàng
ven đường cảnh sắc=cảnh sắc ven đường
Loang lổ thảo nguyên=thảo nguyên loang lổ
mạnh mẽ thị giác năng lực=năng lực thị giác mạnh mẽ
cấm ma chi tác=Cấm Ma Chi Tác
nguyên tố lực lượng=lực lượng Nguyên Tố
ám diễm phi nha=Ám Diễm Phi Nha
Tiềm Long bảng=bảng Tiềm Long
Âm thanh ngọt ngào=giọng nói ngọt ngào
âm thanh lãnh đạm=giọng nói lãnh đạm
trong phòng vang lên=vang lên trong phòng
Đông Hoa phủ=phủ Đông Hoa
dạng này cũng tốt=như vậy cũng tốt
nhưng mà dạng này=nhưng mà như vậy
nghiền ngẫm nụ cười=nụ cười nghiền ngẫm
một tia nghiền ngẫm nụ cười=một nụ cười nghiền ngẫm
không thế nào phiền phức=không quá phiền phức
cùng hắn cùng lúc xuất hiện=xuất hiện với hắn
đồng môn sư huynh đệ=sư huynh đệ đồng môn
Giảo hoạt tiểu quỷ=tiểu quỷ giảo hoạt
lão phu ánh mắt=ánh mắt của lão phu
trữ Kiếm Phi=Trữ Kiếm Phi
một tia mỉm cười thản nhiên=một nụ cười nhàn nhạt
điềm tĩnh khuôn mặt=khuôn mặt điềm tĩnh
thành thục thiếu phụ=thiếu phụ thành thục
ngây ngô thiếu nữ=thiếu nữ ngây ngô
Cấm Ma Chi Tác=dây thừng Cấm Ma
Sáng Tạo Chi Thư=sách Sáng Tạo
tín đồ lãnh địa=lãnh địa tín đồ
ngươi phụ hoàng=phụ hoàng của ngươi
tu vi của ngươi thực lực=tu vi thực lực của ngươi
tinh thần lực dò xét phạm vi=phạm vi dò xét của lực lượng tinh thần
Xem xét cái này hình thể=vừa nhìn cơ thể này
cái này lén lút hành động=hành động lén lút này
đối với ba người dặn dò=dặn dò ba người
Đúng, sư thúc=Vâng, sư thúc
Đại Khánh vương triều=vương triều Đại Khánh
theo linh lực đưa vào=sau khi đưa linh lực vào
hoàng cung diện tích=diện tích hoàng cung
cảnh giới trận pháp=trận pháp cảnh giới
Khổ Huyền hòa thượng=hòa thượng Khổ Huyền
hung quang lóe lên=lóe lên hung quang
bên trong cơ thể linh lực=linh lực trong cơ thể
Màu đen quang mang=quang mang màu đen
Ma Môn thế lực=thế lực Ma Môn
địa bàn cùng tài phú=địa bàn và tài phú
nhiều năm như vậy khổ tu=khổ tu nhiều năm như vậy
như thế ác độc=ác độc như thế
giết người hai chữ=hai chữ giết người
thần hồn bí thuật=bí thuật thần hồn
rất lớn xác suất=xác suất rất lớn
bình tĩnh ánh mắt=ánh mắt bình tĩnh
bức người hàn mang=hàn mang bức người
bận bịu mở miệng=vội vàng mở miệng
Ma môn=Ma Môn
Đã ngươi=nếu ngươi đã
liền thành toàn=sẽ thành toàn
như vậy kém cỏi=kém như vậy
ma môn=Ma Môn
sinh tử lịch luyện=lịch luyện sinh tử
hốt hoảng âm thanh=âm thanh hốt hoảng
một trận hốt hoảng âm thanh=một giọng nói hốt hoảng
Một đạo kinh hoảng âm thanh=một giọng nói kinh hoảng
thanh âm bình tĩnh=giọng nói bình tĩnh
thân ảnh quen thuộc=bóng người quen thuộc
thì đằng không mà lên=lập tức bay lên
màu đen long bào=long bào màu đen
núi lửa khu vực=khu vực núi lửa
hỏa diễm hộ thuẫn=lá chắn hỏa diễm
hạch tâm liệt diễm lò luyện=hạch tâm lò luyện liệt diễm
Xích Viêm tấm chắn=Lá Chắn Xích Viêm
phòng ngự thủ đoạn=thủ đoạn phòng ngự
Từ phù xe bắn tên xoắn ốc=xe bắn tên xoắn ốc Từ Phù
máu phó=Huyết Phó
Huyết Bức=Dơi
huyết dịch=máu
Qủy Hút Máu lãnh chúa=lãnh chúa Qủy Hút Máu
Qủy Hút Máu Chi Ủng=Ủng Hộ Qủy Hút Máu
chủng tộc năng lực=năng lực chủng tộc
Rus lãnh chúa=lãnh cháu Rus
qủy hút máu=Quỷ Hút Máu
quỷ hút máu=Quỷ Hút Máu
không có đánh giết cần thiết=không cần thiết phải đánh giết
Cho tới nguyên nhân=còn về nguyên nhân
kinh nghiệm máng=thanh kinh nghiệm
hắn kinh nghiệm máng tới nói=thanh kinh nghiệm của hắn mà nói
hắn kinh nghiệm máng=thanh kinh nghiệm của hắn
rất nhiều dùng ra=rất nhiều tác dụng
bên trong cảnh tượng buồn nôn=cảnh tượng buồn nôn trong
một cái trợ thủ=một trợ thủ
không sai nghiên cứu=nghiên cứu không tệ
không sai nghiên cứu tư liệu sống=tư liệu sống nghiên cứu không tệ
Qủy Hút Máu pháo đài=pháo đài Qủy Hút Máu
cự long ấp=trứng Cự Long
nguyên sinh Qủy Hút Máu=Qủy Hút Máu thuần khiết
Thủy Tổ quan=Thủy Tổ Quan
trên thân thể=trên cơ thể
Vẫn là nói đây là=không lẽ đây là
sắp chết trạng thái=trạng thái sắp chết
quỷ hút máu lãnh chúa=lãnh chúa Quỷ Hút Máu
cái kia uy thế=uy thế đó
hắn hiện tại=bây giờ hắn đang
đối lập cục thế=thế cục đối lập
so với ta tốt=tốt hơn ta
hai trăm vạn=2 triệu
ba trăm vạn=3 triệu
Âm U sơn mạch=Sơn Mạch Âm U
năm đại cấm khu một trong=một trong năm đại cấm khu
nồng đậm vụ khí=vụ khí nồng đậm
dường như một đầu cự thú=giống như một con thú khổng lồ
đem xung quanh chỗ có sinh vật thôn phệ=cắn nuốt tất cả các sinh vật xung quanh nó
sương mù màu đen bên trong=bên trong sương mù màu đen
vô tận tà ác=tà ác vô tận
lòng người thấy sợ hãi=lòng người cảm thấy sợ hãi
tứ đại cấm khu=bốn đại cấm khu
cường đại Yêu thú=Yêu thú cường đại
cực kỳ cường đại Yêu thú=Yêu thú cực kỳ cường đại
cực kỳ khủng bố quái vật=quái vật cực kỳ khủng bố
khủng bố quái vật=quái vật khủng bố
Chỗ lấy được xưng là cấm khu=nó được gọi là cấm khu
kinh khủng chủng tộc=chủng tộc kinh khủng
một cái kinh khủng chủng tộc=một chủng tộc kinh khủng
Âm U tộc=tộc Âm U
bình thường thủ đoạn=thủ đoạn bình thường
đối với bọn nó không dùng=không có tác dụng đối với bọn nó
Người bình thường nếu là=nếu người bình thường
hẳn phải chết không nghi ngờ=chắc chắn một trăm phần trăm sẽ chết
đại quy mô=quy mô lớn
là thật là giả=là thật hay giả
đen nhánh rừng rậm=rừng rậm đen nhánh
mênh mông đen nhánh rừng rậm=rừng rậm đen nhánh mênh mông
bí mật căn cứ=căn cứ bí mật
còn có nào cường giả=còn có cường giả nào
tối cường giả=cường giả mạnh nhất
là tu vi gì=có tu vi gì
rất chuyện dễ dàng=chuyện rất dễ dàng
hệ thống mặt bảng=bảng thông tin của hệ thống
luyện đan đại sư=Luyện Đan Sư
Trận Pháp sư=Trận Pháp Sư
Bình phục một chút tâm tình=Thu hồi làm cảm xúc của mình
làm lên chính sự tới=làm chính sự
nơi này có khả năng=có khả năng nơi này
Ngươi cái này mãng phu=một tên mãng phu như ngươi
cái kia mấy cái đại thế lực=mấy đại thế lực kia
có gì có thể sợ=có gì đáng sợ
tuyệt đỉnh cường giả=cường giả tuyệt đỉnh
trong bóng tối điều tra=âm thầm điều tra
trong đại điện tất cả mọi người=tất cả mọi người trong đại điện
trận đại chiến kia bên trong=trong trận đại chiến
từng đạo hốt hoảng tiếng kinh hô=từng tiếng kinh hô hoảng hốt
Từng đạo tiếng xé gió=từng tiếng xé gió
Một đạo quát chói tai âm thanh=một tiếng quát chói tai
một chút chung quanh=xung quanh một chút
cỗ này đặc biệt ba động=luồng ba động đặc biệt này
khí tức cường đại bóng người=bóng người có khí tức cường đại
cường đại tinh thần lực=lực lượng tinh thần cường đại
khuếch tán mà ra=khuếch tán ra
cơ hồ=gần như
tản mát ra=tản ra
một vệt dị sắc=một tia dị sắc
màu đen đao mang=đao mang màu đen
lệ mang lóe lên=lóe lên lệ mang
về hướng phía dưới rơi đi=rơi xuống phía dưới
thần hồn hư ảnh=hư ảnh thần hồn
cầm lấy một tia cười lạnh=lộ ra một nụ cười lạnh
hư không xuyên qua=xuyên qua hư không
không gian bảo vật=bảo vật không gian
từ trong tay hắn chạy thoát=chạy thoát khỏi tay hắn
màu tím khói bụi=khói bụi màu tím
màu đen giọt nước=giọt nước màu đen
kinh thiên gào thét=gào thét rung trời
thích hợp mai phục địa điểm=địa điểm mai phục thích hợp
cái này quy mô=quy mô cái này
tại nham tương bên trong=trong dung nham
bụng bên trong=trong bụng
quá lớn thương hại=sát thương quá lớn
hỗn loạn vô cùng=vô cùng hỗn loạn
“="
”="
sinh vật hủ hóa=sinh vật biến dị
thiên tài đầu tiên=thiên tài đứng đầu
khu vực hủ hóa=khu vực biến dị
kết quả xét nghiệm=kết quả kiểm tra
robot=người máy
Lực từ trường hủ hóa=Lực Từ Trường Biến Dị
quái vật hủ hóa=quái vật biến dị
dung nham thú=Dung Nham Thú
kịch liệt chiến đấu=chiến đấu kịch liệt
cơ giáp phòng ngự=người máy phòng ngự
bán nguyệt trảm=Bán Nguyệt Trảm
cự thú dung nham=Cự Thú Dung Nham
đầu nguồn hủ hóa=đầu nguồn biến dị
cơ sư cao cấp=phi công cao cấp
Mức độ hủ hóa=mức độ biến dị
Nhu cầu sử dụng=yêu cầu sử dụng
Đô la Liên bang=đồng Liên Bang
độ hủ hóa=độ biến dị
hủ hóa=biến dị
Đại địa nóng chảy=Đại Địa Nóng Chảy
Dung Nham Trọng Kiếm=Trọng Kiếm Dung Nham
Dung Nham Chiến Khôi=Chiến Khôi Dung Nham
Áo giáp ngực dung nham=Áo Giáp Ngực Dung Nham
Cánh tay người máy địa huyệt=Cánh Tay Người Máy Địa Huyệt
Chân máy địa huyệt=Chân Người Máy Địa Huyệt
Lá chắn điện năng=Lá Chắn Điện Năng
phòng ngự mặt đất=Phòng Ngự Mặt Đất
Hạch tâm năng lượng=Hạch Tâm Năng Lượng
đại địa nóng chảy=Đại Địa Nóng Chảy
liên bang tệ=đồng Liên Bang
khiếp sợ cùng ngoài ý muốn=khiếp sợ và ngoài ý muốn
liên bang=Liên Bang
tiền tệ liên bang=đồng Liên Bang
Liên bang Tệ=đồng Liên Bang
căn cứ Tinh Hoàn=căn cứ Tinh Vòng Liên Bang
kịch liệt giao phong=giao phong kịch liệt
chiến tích giao diện=giao diện chiến tích
Hắc Phong Kỵ Sĩ=Kỵ Sĩ Hắc Phong
dung nham trọng kiếm=Trọng Kiếm Dung Nham
trọng kiếm dung nham=Trọng Kiếm Dung Nham
cánh tay cơ giới=cánh tay người máy
vừa mới cái kia động tĩnh=động tĩnh vừa rồi
có bao nhiêu lợi hại=quá lợi hại hay gì
trên người đồ tốt=đồ tốt trên người
càng là nhiều đến=nhiều đến mức
tu luyện này tư nguyên=tài nguyên tu luyện này
đối với hắn có dùng=có tác dụng đối với hắn
thời gian dư thừa=dư thời gian
hắn tối nay=tối nay hắn
sự tình cần bận bịu=chuyện cần phải làm
Cũng tỷ như=ví dụ như
một khác bí ẩn cứ điểm=một căn cứ bí mật khác
một cái rất nhỏ thành trì=một thành trì rất nhỏ
thành trì quy mô=quy mô thành trì
thành trì quy mô thậm chí=thậm chí quy mô của tòa thành trì này
đều muốn nhỏ hơn một số=còn nhỏ hơn một chút
trong thành cường giả mạnh nhất=cường giả mạnh nhất trong thành
tam đại gia tộc=ba đại gia tộc
tả hộ pháp=Tả hộ pháp
trong bóng tối an bài tới=âm thầm an bài trong bóng tối
Cấm Không Trận Pháp=Trận Pháp Cấm Không
Cấm Không đại trận=Đại Trận Cấm Không
thuận lợi hoàn thành=hoàn thành thuận lợi
Tuy nhiên thời gian=tuy thời gian
một chút hơi dài một chút điểm=hơi lâu một chút
một cái bí mật=một bí mật
đời thứ ba môn chủ=môn chủ đời thứ ba
Nếu là có thể=nếu như có thể
cường đại tồn tại=tồn tại cường đại
ở trong đó tu luyện=tu luyện ở trong đó
chỗ này thần bí chi địa=chỗ thần bí chi địa này
đồng dạng nội dung cốt truyện=nội dung cốt truyện thường gặp
quá lớn nguy hiểm=nguy hiểm quá lớn
toàn thân khí tức=toàn thân khí tức
từ phù phi xa=xe bay Từ Phù
Tinh Linh tộc=tộc Tinh Linh
Hổ Báo Kỵ=kỵ sĩ Hổ Báo
Nơi này dù sao=dù sao nơi này
trăng chi tế ti=Trăng Chi Tế Ti
Máu tươi lực lượng=Lực Lượng Máu Tươi
sơ ủng tinh huyết=Tinh Huyết Sơ Ủng
nguyên tố năng lực=năng lực nguyên tố
tinh linh=Tinh Linh
Quyền luật Hỗn Độn=Quyền Luật Hỗn Độn
phía dưới tràng cảnh=cảnh tượng phía dưới
ở trong rừng du đãng=du đãng ở trong rừng
hồ nhỏ xung quanh=xung quanh hồ nhỏ
đặc biệt hoàn cảnh=hoàn cảnh đặc biệt
linh hồn công kích=tấn công linh hồn
cái kia mảnh hồ nhỏ=cái hồ nhỏ kia
đại lượng hồn lực=hồn lực rất mạnh
đối với ta hữu dụng=hữu dụng đối với ta
cấp bậc nhân vật nào=nhân vật cấp bậc nào
Có thể nếu để cho hắn=nhưng nếu muốn hắn
cứ như vậy từ bỏ=từ bỏ như vậy
nếu là không lấy tới=nếu như không lấy
để hắn cứ như vậy từ bỏ=muốn hắn dễ dàng từ bỏ như vậy
nơi này hư thực=hư thực nơi này
Nơi này tuy nhiên=tuy nơi này
vương thành lớn nhất=lớn nhất vương thành
vương thành lớn nhất thanh lâu=thanh lâu lớn nhất vương thành
Nơi này cô nương=cô nương nơi này
mọi thứ tinh thông=tinh thông mọi thứ
có tu vi tại thân=có tu vi trên người
Cái kia người ánh mắt=ánh mắt người kìa
cái kia bên trong tư vị=tư vị ở trong đó
không thích hợp chỗ=chỗ không thích hợp
sớm liền mở ra=sớm đã mở ra
sinh hoạt vật tư=vật tư sinh hoạt
mở ra dấu hiệu=dấu hiệu mở ra
gia tộc thực lực=thực lực gia tộc
trong đêm chạy trốn=chạy trốn trong đêm
như thế sự tình=chuyện như thế
đối với một bên đại ca nói=nói với đại ca ở bên cạnh
kịch liệt đại chiến=đại chiến kịch liệt
như thế dũng mãnh=dũng mãnh như thế
tu luyện trên đường=trên đường tu luyện
bọn họ hai sư huynh đệ=hai sư huynh đệ bọn họ
Thời không hệ pháp thuật=pháp thuật hệ Không Gian và Thời Gian
yên diệt pháp cầu=Yêu Diệt Pháp Cầu
Nguyên Tố Chi Tử=Con Cưng Của Nguyên Tó
sử thi=Sử Thi
sử thi cấp bậc=cấp Sử Thi
thiểm điện phong bạo=Phong Bạo Sấm Sét
Tam vĩ ngân long thảo=cỏ Tam Vĩ Ngân Long
thị trường=Trung Tâm
thi pháp=thi triển pháp thuật
lực từ sóng áo thuật=sóng pháp thuật Lực Từ
hoàng kim sáo trang=bộ giáp Hoàng Kim
hắn như thế nào làm được=sao hắn có thể làm được như vậy
điểm thương tổn=điểm sát thương
hoàn mỹ ngăn cản=ngăn cản hoàn mỹ
cơ sư phòng ngự=phi công phòng ngự
kịch liệt chấn động=chấn động kịch liệt
hoàn toàn khống chế=khống chế hoàn toàn
kịch liệt run rẩy=run rẩy kịch liệt
cơ sư chuyên nghiệp=phi công chuyên nghiệp
màu xanh tinh thể=tinh thể màu xanh
cơ sư chính thức=phi công chính thức
cơ sư nhập môn=phi công nhập môn
toàn bộ giải quyết=giải quyết toàn bộ
quái vật mục nát=quái vật biến dị
học viện người máy=học viện Người Máy
chiến đấu hệ=hệ chiến đấu
che giấu khí tức thủ đoạn=thủ đoạn che giấu khí tức
Dẫn đầu nam tử=nam tử dẫn đầu
một trận đau đớn=một cơn đau đớn
về hướng sau lưng bỏ chạy=bỏ chạy về hướng sau lưng
cơ bản trận pháp=trận pháp cơ bản
quỷ dị ánh mắt=ánh mắt quỷ dị
thẩm vấn thủ đoạn=thủ đoạn thẩm vấn
ngập trời hận ý=hận ý ngập trời
từ nhỏ đã quen biết=quen biết từ nhỏ đã
nhiều năm giao tình=giao tình nhiều năm
xuất sắc thiên phú=thiên phú xuất sắc
Hỗn Độn khế ước=khế ước Hỗn Độn
khế ước quyển trục=quyển trục khế ước
Tử Vong Nhất Chỉ=Một Chỉ Tử Vong
lưu hỏa chi tường=Bức Tường Lưu Hỏa
tối tăm chi vực=Vực Sâu Tối Tăm
Du Nặc quân quân doanh=quân doanh quân Du Nặc
Thanh Xuyên binh binh doanh=Binh doanh binh lính Thanh Xuyên
Toa Long Cự Ưng=chim Ưng Toa Long Khổng Lồ
Thanh Xuyên binh binh doanh=binh doanh binh lính Thanh Xuyên
cấp bậc kiến trúc=kiến trúc cấp
Đằng Viêm Chi Luân=Vòng Xoáy Lửa
đại khôi lỗi thuật=Đại Khôi Lỗi Thuật
mấy chục vạn=mấy trăm ngàn
đặc biệt bối cảnh=bối cảnh đặc biệt
tán tu cường giả=cường giả tán tu
quá mức hà khắc=quá hà khắc
bán thân nhân=Nửa Người Khỉ
đỉnh phong chiến lực=chiến lực đỉnh phong
phấn đấu mục tiêu=mục tiêu phấn đấu
ngập trời chiến ý=chiến ý ngập trời
đơn giản giới thiệu=giới thiệu đơn giản
hắc ám chi duy=Hắc Ám Chi Duy
kết tinh năng lượng=năng lượng kết tinh
hàn phách tinh tủy mỏ=Mỏ Tinh Tủy Hàn Phách
Hàn phách tinh tủy=Tinh Tủy Hàn Phách
đinh hỏa chi lực=Đinh Hỏa Chi Lực
tân kim chi lực=Tân Kim Chi Lực
mậu thổ chi lực=Mậu Thổ Chi Lực
kỷ thổ chi lực=lực lượng Kỷ Thổ
Đinh Hỏa Chi Lực=lực lượng Đinh Hỏa
Tân Kim Chi Lực=lực lượng Tân Kim
Mậu Thổ Chi Lực=lực lượng Mậu Thổ
Kim nhân=Kim Nhân
ma diễm cát=cát Ma Diễm
bộ đội ngoại biên=bộ đội biên phòng
đại bộ phận người=đa số người
đáng sợ vô cùng=vô cùng đáng sợ
đích hệ huyết mạch=huyết mạch đích hệ
phổ thông vật phẩm=vật phẩm phổ thông
tại khay bên trong=trong khay
Kiện thứ nhất vật phẩm bán đấu giá vì=vật phẩm bán đấu giá thứ nhất chính là
phổ thông chỗ ngồi=chỗ ngồi phổ thông
còn không có xuất thủ=còn chưa ra tay
một gian bao sương bên trong=trong một căn phòng
im bặt mà dừng=đột nhiên im bặt
Đạo âm thanh này=giọng nói này
nhìn không thấy=không nhìn thấy
đỉnh phong tồn tại=tồn tại đỉnh phong
Phía dưới đấu giá kiện thứ hai vật phẩm bán đấu giá=Tiếp theo, vật phẩm bán đấu giá thứ hai
ra giá âm thanh=âm thanh ra giá
dễ nghe êm tai âm thanh=giọng nói êm tai dễ nghe
thứ ba vật phẩm bán đấu giá=vật phẩm đấu giá thứ ba
lần đấu giá này vật phẩm=vật phẩm đấu giá lần này
thâm hậu bối cảnh=bối cảnh thâm hậu
bình thường đồ vật=đồ vật bình thường
Đến đón lấy bán đấu giá=vật phẩm bán đấu giá tiếp theo
phòng đấu giá phía trên=phía trên phòng đấu giá
thì vang lên liên tiếp tiếng gọi giá=đã liên tiếp vang lên tiếng kêu giá
đạo tuổi trẻ âm thanh=giọng nói trẻ tuổi
đạo khinh thường âm thanh=giọng nói tràn đầy khinh thường
cùng ta tranh giành=tranh giành với ta
tối đa cũng liền=cao nhất cũng chỉ
thiên tài con cháu=con cháu thiên tài
đại gia tộc thiên tài con cháu=con cháu thiên tài của đại gia tộc
hiện tại tình cảnh này=tình cảnh giống như bây giờ
đùa cợt âm thanh=giọng nói đùa cợt
chính mình cái này cháu trai=đứa cháu trai này của mình
là cái kẻ ngu=là một người ngu
phần lớn người tới nói=đa số người khác
thiên phú kỳ kém vô cùng=thiên phú cũng cực kỳ kém
truyền thừa bảo vật=bảo vật truyền thừa
phổ thông linh khí=linh khí phổ thông
sinh tử ma luyện=ma luyện sinh tử
trên diện rộng tu vi=tu vi trên diện rộng
đạo âm thanh hùng hậu=giọng nói hùng hậu
linh thạch không đủ=không đủ linh thạch
hay không linh thạch không đủ=không đủ linh thạch hay không
Đến đón lấy cái này vật phẩm đấu giá=vật phẩm đấu giá tiếp theo
cùng ta có duyên=có duyên với ta
vật cưỡi sào huyệt=sào huyệt vật cưỡi
Xích Bạch kỵ sĩ doanh=doanh trại kỵ sĩ Xích Bạch
Ofey chiến đoàn=chiến đoàn Ofey
cánh sắt Griffin sào huyệt=sào huyệt Griffin cánh sắt
triệu hoán chi kính=kính Triệu Hoán
nhất phi trùng thiên=một bước lên trời
áo thuật mô hình=mô hình pháp thuật
Tử" Kim Nhân=Kim Nhân Tử
"Dần" Kim Nhân=Kim Nhân Dần
"Tị" Kim Nhân=Kim Nhân Tỵ
"Sửu" Kim Nhân=Kim Nhân Sửu
"Thân" Kim Nhân=Kim Nhân Thân
"Hợi" Kim Nhân=Kim Nhân Hợi
hắc kim trúc lâm=rừng trúc Hắc Kim
nhà họ Hồng=Hồng gia
nhà họ Sở=Sở gia
cùng người kia tranh đoạt=tranh đoạt với người kia
báo nhân=Người Báo
Du Nặc binh=lính Du Nặc
cơ sư trung cấp=phi công trung cấp
trung cấp cơ sư=phi công trung cấp
nhìn không ra=không nhìn ra
cơ sư cấp thấp=phi công cấp thấp
so với chúng ta tưởng tượng=trong tưởng tượng của chúng ta
không có biện pháp=không thể
trong lòng chấn động không thôi=trong lòng cực kỳ chấn động
có bao nhiêu khủng bố=khủng bố cỡ nào
hủy thiên diệt địa=như muốn phá hủy trời đất
Griffin=Điểu Sư
phân đội thứ năm=phân đội số 5
Dự trữ năng lượng=năng lượng dự trữ
Bất Tử Đằng=Dây Leo Bất Tử
trước tiên đem chúng giải quyết=giải quyết chúng trước đã
hoảng sợ vô cùng=vô cùng hoảng sợ
Vũ nhân tộc=tộc Người Chim
Ngạc ngư nhân=Người Cá Sấu
Lang nhân=Người Sói
Dã trư nhân=Người Heo Rừng
Tượng nhân=Người Voi
ưu tú huyết mạch=huyết mạch ưu tú
gia tộc đại trận=đại trận gia tộc
hắc giáp hộ vệ=hộ vệ mặc giáp đen
vừa đi vừa về tuần tra=tuần tra qua lại
hắn giấc mộng trong lòng=giấc mộng trong lòng hắn
đem cái này trở ngại trừ bỏ=trừ bỏ trở ngại này
một đạo có chút âm thanh=một giọng nói có chút
gia tộc nô bộc=nô bộc trong gia tộc
Theo cái này có thể=từ đây có thể
cái gì đặc biệt huyết mạch=huyết mạch đặc biệt gì
tư nguyên vô số=vô số tư nguyên
như thế kỳ lạ=kỳ lạ như thế
như thế nào thủ đoạn=thủ đoạn như thế nào
trong mật thất cái kia đạo uy áp=luồng uy áp trong mật thất
tu vi thấp hộ vệ=hộ vệ tu vi thấp
Cái này đạo khí tức=khí tức này
đến đem tin tức này truyền=nhanh truyền tin tức này
cái này đạo khí tức=luồng khí tức này
đạo này uy áp cường đại=luồng uy áp cường đại này
lão phu sau này=sau này lão phu
Mật thất cửa đá=cửa đá mật thất
Tiếp theo một cái chớp mắt=trong một chớp mắt tiếp theo
một đạo sắc bén chi sắc=một tia sắc bén
theo lão tổ trong mắt=từ trong mắt lão tổ
so với hắn muốn sớm hơn=còn sớm hơn hắn
tàn nhẫn sát hại=sát hại tàn nhẫn
ngưng trọng mà hỏi=ngưng trọng hỏi
chiếc người máy=người máy
sinh mệnh khống chế=Khống Chế Sinh Mệnh
năng lượng hao hết=hao hết năng lượng
lần sau đâu?=lần sau thì sao?
càng phát ra chật vật=càng ngày càng chật vật
cùng ngươi không có bao nhiêu quan hệ=không có liên quan gì đến ngươi
còn tác động đến không đến=còn không đủ để ảnh hưởng đến
Nhưng trước mắt tiểu tử này=nhưng tiểu tử trước mắt này
Nghĩ thông suốt sau này=sau khi suy nghĩ thông suốt
bồi ngươi đi qua=đi cùng ngươi
tiền bối ân tình=ân tình của tiền bối
từ trên bầu trời bay qua=bay qua trên bầu trời
cường đại linh áp=linh áp cường đại
về hướng hoàng cung phương hướng bay đi=bay về phương hướng hoàng cung
Thật cường đại linh áp=linh áp Thật cường đại
quan trọng chi địa=nơi quan trọng
cấm quân thống lĩnh=thống lĩnh cấm quân
hoàng cung cửa lớn=cửa lớn hoàng cung
lại là mở rộng=lại mở rộng
hoàng cung cấm quân=cấm quân hoàng cung
chức trách cũng là=chức trách chính là
không rõ nhân sĩ=nhân sĩ không rõ danh tính
trên người khôi giáp=khôi giáp trên người
hay không hài tử=hài tử hay không
Nói lên cái này=nói đến chuyện này
ta thấy không thấu=ta không nhìn thấu
so ta phải cường đại=mạnh hơn ta
mà phần lớn người khí tức=khí tức của đa số người trong đó
khôi ngô hán tử=hán tử khôi ngô
cường giả ở giữa chiến đấu=trận chiến giữa các cường giả
hoàng cung chỗ sâu=chỗ sâu trong hoàng cung
loại này sự tình=loại chuyện này
khẩn cầu thần sắc=vẻ khẩn cầu
so với khóc còn khó coi hơn=còn khó coi hơn cả khóc
Bất tử Nguyên Tuyền=Bất Tử Nguyên Tuyền
Đọa Lạc Chi Nhận=Đọa Lạc Chi Nhận
Sinh mệnh sung năng=Sinh Mệnh Sung Năng
Tư thế phòng ngự=Tư Thế Phòng Ngự
Đọa Lạc Chi Thuẫn=Lá Chắn Đọa Lạc
Sinh mệnh nạp điện=Sinh Mệnh Sung Năng
Tư thế tấn công=Tư Thế Tấn Công
hắn phỏng chừng=có lẽ hắn
Vừa rồi chiến đấu=chiến đấu vừa rồi
Hắn dĩ nhiên thua=không ngờ hắn lại thua
trên bầu trời xẹt qua=xẹt qua trên bầu trời
trong buồng lái vang lên=vang lên trong buồng lái
chuẩn xác ngăn cản=ngăn cản chuẩn xác
đạo âm thanh vội vàng=giọng nói vội vàng
mấy cái nô bộc=mấy nô bộc
ngưng trọng biểu lộ=biểu lộ ngưng trọng
chân chính kẻ địch=kẻ địch chân chính
như cũ đứng thẳng=đứng thẳng như cũ
chính thức phi công=phi công chính thức
thế mà liền một cái=thế nhưng ngay cả một
Bất Tử dây leo=Dây Leo Bất Tử
yếu ớt thân thể=thân thể yếu ớt
tư thái tiến công=tư thế tiến công
Đám người bên trong=trong đám người
thảo luận chủ đề=chủ đề thảo luận
Sân quyết đấu bên trong=trong sân quyết đấu
tư thái hoán đổi=hoán đổi tư thái
phòng làm việc bên trong=trong phòng làm việc
nào đó yên lặng=yên tĩnh nào đó
cơ giáp dàn khung=dàn khung người máy
nộ trừng=tức giận trừng mắt
ngừng lại bước chân=ngừng bước chân lại
cái này mới=lúc này hắn mới
Gặp hắn an tĩnh lại=thấy hắn đã an tĩnh lại
Cùng ta có quan hệ?=có liên quan với ta?
Liền là cái này=chính là cái này
Liên Bang diễn đàn=diễn đàn Liên Bang
thiết kế đại sư=đại sư thiết kế
danh nhân đường bên trong=trong danh nhân đường
trầm tư bên trong=trong trầm tư
tên người máy sinh học đỉnh tiêm nhà thiết kế=nhà thiết kể người máy sinh học hàng đầu
đặc biệt cơ giáp=người máy đặc biệt
có thể nhẹ nhõm=có thể nhẹ nhàng
Loại kỹ thuật này một khi=một khi Loại kỹ thuật này
đỉnh tiêm cơ giáp=người máy hàng đầu
cái này thiết kế=thiết kế này
kiểm tra không ra=không kiểm tra ra được
ta cái này đi làm=ta sẽ đi làm ngay
nhà nào oa tử=oa tử nhà nào
thoát ly cơ giáp=rời khỏi người máy
Cái này có thể giống nhau sao=chuyện này sao giống nhau được
Người ta tiểu hỏa tử=tiểu hỏa tử Người ta
tán thưởng bắt đầu=bắt đầu tán thưởng
đề thăng một điểm=tăng lên một chút
sinh tử chiến đấu=chiến đấu sinh tử
có bao nhiêu trâu bò đâu=trâu bò cỡ nào đâu
trở về không kịp=không trở về kịp
Cùng đối phương tán gẫu=tán gẫu với đối phương
đầu óc có phải=có phải đầu óc
Có người thậm chí=thậm chí có người
xa xôi còn về=xa xôi đến mức
theo gió tung bay=tung bay theo gió
cùng ngươi tuổi không sai biệt lắm=tuổi tác cũng tương đương với ngươi
náo nhiệt vô cùng=vô cùng náo nhiệt
địa phương khảo nghiệm=nơi khảo nghiệm
hối hận cùng tự trách=hối hận và tự trách
Chen Nan=Trần Nam
Annan Pharmaceutical=Công ty Dược phẩm An Nam
An Nam chế dược=Công ty Dược phẩm An Nam
Xiling Pharmaceutical=Công ty Dược phẩm Tây Lăng
Tây Lăng y dược=Công ty Dược phẩm Tây Lăng
Chen Jinhe=Trần Kim Hà
Dương giáo sư=giáo sư Dương
Giáo sư Yang=giáo sư Dương
thành phố Yuancheng=thành phố Nguyên Thành
Yuancheng=Nguyên Thành
Zhao Houcai=Triệu Hậu Tài
Chen Wenyin=Trần Văn Nhân
vượt cấp khiêu chiến=khiêu chiến vượt cấp
Hủy Diệt Lốc Phong=Gió Lốc Hủy Diệt
Trịnh lão=lão Trịnh
Hạn chế giải trừ=giải trừ hạn chế
mảnh hồng sắc lốc xoáy=cơn lốc xoáy màu hồng
tận khả năng ngăn cản=cố hết sức năng cản
hung hăng đụng vào=va chạm thật mạnh lên
đem chuyện này ghi nhớ=ghi nhớ chuyện này
chúng bây giờ ta=bây giờ chúng ta
làm cái gì bây giờ=làm gì đây
Một đạo âm thanh=một giọng nói
cấp quân vương=cấp Quân Vương
Từ Duệ=Hứa Duệ
Xiaolin=Tiểu Lâm
Xu Rui=Hứa Duệ
bác sĩ Chen=bác sĩ Trần
He Duankang=Hà Thụy Khang
Xiao Chen=Tiểu Trần
Xiao Lin=Tiểu Lâm
Yang Hongnian=Dương Hoằng Niệm
Zhao Jianyong=Triệu Kiến Dũng
UU Reading www.uukanshu.com=
Sun Xiaoyong=Tôn Hiểu Dũng
Li Mengsan=Lý Mạnh Tam
Huyện ủy Xigang=Huyện ủy Tân Cảng
Đấu Trường Võ=Võ Đấu Trường
một đạo âm thanh=một giọng nói
Bất Diệt Thần Thể=Thần Thể Bất Diệt
Thanh Mộc Thần Quyết=Thần Quyết Thanh Mộc
nội vụ trưởng lão=trưởng lão nội vụ
cường tráng trung niên=trung niên cường tráng
ngoại vụ trưởng lão=trưởng lão ngoại vụ
khách khanh trưởng lão=trưởng lão khách khanh
Cao Meijuan=Cao Mỹ Quyên
He Ruikang=Hà Thụy Khang
Dương Hoằng Niên=Dương Hoằng Niệm
bệnh nhân=người bệnh
đánh dấu thu hoạch=điểm danh thành công, nhận
mười ngày tu vi=tu vi mười ngày
Đánh dấu lấy được tu vi=điểm danh nhận được tu vi
Phải chăng lập tức=Có muốn lập tức
【 đồ vật 】=【 Vật phẩm 】
【 phẩm giai 】=【Phẩm cấp 】
【 công năng 】=【 Chức năng 】
hộ sơn đại trận=đại trận hộ sơn
đại trận uy lực=uy lực của đại trận
trung cấp rút thưởng=rút thưởng trung cấp
cao cấp rút thưởng=rút thưởng cao cấp
sơ cấp rút thưởng=rút thưởng sơ cấp
biển Chết Vô Tận=Vô Tận Tử Hải
thế giới mười phương lớn=Thập Phương Đại Thế Giới